match_id,my_team,team1_gold,team2_gold,gold_diff,gold_leading_team,my_team_ahead_gold,team1_kills,team2_kills,kill_diff,kill_leading_team,my_team_ahead_kills,my_team_win,winner
LA1_1638676023,100,17375,15050,2325,100,False,7,3,4,100,True,True,100
LA1_1636273150,200,17156,16124,-1032,100,False,7,4,-3,100,True,True,200
LA1_1636973011,100,16978,17391,-413,200,False,6,6,0,0,False,False,200
LA1_1634780232,200,17277,19532,2255,200,False,6,12,6,200,False,True,200
LA1_1638669325,200,16688,19028,2340,200,False,6,8,2,200,False,True,200
LA1_1634740860,100,16035,19250,-3215,200,False,6,11,-5,200,False,False,200
LA1_1635230965,100,15657,16340,-683,200,False,4,4,0,0,False,True,100
LA1_1637145351,200,15760,16421,661,200,False,5,6,1,200,False,False,100
LA1_1636981603,100,16682,15748,934,100,False,7,5,2,100,True,True,100
LA1_1635228953,100,15697,16186,-489,200,False,3,4,-1,200,False,True,100
LA1_1635043958,200,16958,16824,-134,100,False,6,8,2,200,False,True,200
LA1_1634768011,100,15617,16578,-961,200,False,4,5,-1,200,False,True,100
LA1_1634788327,200,16819,16646,-173,100,False,9,7,-2,100,True,True,200
LA1_1636063481,100,15980,15882,98,100,False,3,5,-2,200,False,True,100
LA1_1636053293,100,18568,14875,3693,100,False,10,3,7,100,True,True,100
LA1_1637916138,100,17446,14305,3141,100,False,6,1,5,100,True,True,100
LA1_1634795704,100,16164,16258,-94,200,False,6,5,1,100,True,False,200
LA1_1639258053,200,16071,17550,1479,200,False,6,6,0,0,False,False,100
LA1_1635054114,200,16457,21176,4719,200,False,5,18,13,200,False,True,200
LA1_1638663727,200,17414,17887,473,200,False,7,8,1,200,False,False,100
LA1_1636991257,200,16617,17451,834,200,False,6,8,2,200,False,True,200
LA1_1637139798,100,17530,17923,-393,200,False,8,9,-1,200,False,False,200
LA1_1636770126,200,15533,16550,1017,200,False,2,5,3,200,False,False,100
LA1_1635233799,200,18169,14033,-4136,100,False,8,1,-7,100,True,False,100
LA1_1635285279,200,16655,17027,372,200,False,5,7,2,200,False,True,200
LA1_1635547248,100,18663,16632,2031,100,False,9,5,4,100,True,True,100
LA1_1637386727,200,17846,15727,-2119,100,False,8,4,-4,100,True,False,100
LA1_1634824290,200,16529,19536,3007,200,False,6,10,4,200,False,True,200
LA1_1635296210,100,20493,17151,3342,100,False,15,7,8,100,True,True,100
LA1_1636695437,200,17680,16551,-1129,100,False,8,6,-2,100,True,True,200
LA1_1634993585,100,18043,16786,1257,100,False,9,7,2,100,True,True,100
LA1_1638493966,200,15484,19485,4001,200,False,3,13,10,200,False,True,200
LA1_1638093481,100,17139,18669,-1530,200,False,5,8,-3,200,False,False,200
LA1_1638466997,100,17025,19298,-2273,200,False,6,14,-8,200,False,True,100
LA1_1635063072,200,17351,17246,-105,100,False,5,7,2,200,False,True,200
LA1_1636963408,200,17172,16894,-278,100,False,8,7,-1,100,True,True,200
LA1_1637044348,200,16542,16794,252,200,False,4,7,3,200,False,False,100
LA1_1636527547,100,18685,15346,3339,100,False,9,3,6,100,True,True,100
LA1_1634998705,200,16731,16537,-194,100,False,6,8,2,200,False,False,100
LA1_1636043974,100,19331,16053,3278,100,False,11,4,7,100,True,True,100
LA1_1634811741,100,16448,17471,-1023,200,False,7,7,0,0,False,True,100
LA1_1642808703,100,21264,14725,6539,100,False,14,3,11,100,True,True,100
LA1_1637627973,200,17449,16896,-553,100,False,7,6,-1,100,True,False,100
LA1_1638087712,200,14271,18118,3847,200,False,2,10,8,200,False,True,200
LA1_1641187977,100,14938,17085,-2147,200,False,3,7,-4,200,False,False,200
LA1_1642745006,100,16519,16552,-33,200,False,5,7,-2,200,False,False,200
LA1_1642782198,100,17560,14848,2712,100,False,6,1,5,100,True,True,100
LA1_1636333334,200,18039,17804,-235,100,False,10,7,-3,100,True,False,100
LA1_1635278463,100,17412,17586,-174,200,False,9,8,1,100,True,True,100
LA1_1636786226,200,16859,19107,2248,200,False,6,10,4,200,False,True,200
LA1_1639068115,100,17582,18475,-893,200,False,7,9,-2,200,False,False,200
LA1_1637669059,200,16846,16689,-157,100,False,6,5,-1,100,True,True,200
LA1_1640506683,100,20045,13179,6866,100,False,12,1,11,100,True,True,100
LA1_1629627372,100,19856,17477,2379,100,False,15,10,5,100,True,True,100
LA1_1633376291,200,17302,15351,-1951,100,False,7,2,-5,100,True,False,100
LA1_1628688685,100,16901,17355,-454,200,False,3,6,-3,200,False,True,100
LA1_1632743238,200,17617,16298,-1319,100,False,6,5,-1,100,True,True,200
LA1_1636567732,100,14400,18221,-3821,200,False,2,8,-6,200,False,False,200
LA1_1633133845,100,18740,15637,3103,100,False,9,4,5,100,True,True,100
LA1_1635519980,100,16853,18540,-1687,200,False,6,13,-7,200,False,True,100
LA1_1634598839,100,20907,15529,5378,100,False,18,5,13,100,True,True,100
LA1_1636116347,200,18079,18697,618,200,False,9,9,0,0,False,False,100
LA1_1632513784,100,17150,14590,2560,100,False,6,2,4,100,True,True,100
LA1_1628714391,100,16476,18368,-1892,200,False,4,10,-6,200,False,False,200
LA1_1629635301,200,18527,18252,-275,100,False,10,9,-1,100,True,True,200
LA1_1634867512,200,17577,16310,-1267,100,False,7,4,-3,100,True,True,200
LA1_1639967891,200,16937,18689,1752,200,False,7,10,3,200,False,False,100
LA1_1640208385,100,18446,17139,1307,100,False,10,5,5,100,True,True,100
LA1_1631499860,200,16795,18700,1905,200,False,6,12,6,200,False,True,200
LA1_1632963852,200,16294,16516,222,200,False,5,5,0,0,False,True,200
LA1_1634049999,100,14954,16103,-1149,200,False,2,3,-1,200,False,True,100
LA1_1631701300,200,14015,18050,4035,200,False,1,10,9,200,False,True,200
LA1_1639050962,200,16447,18299,1852,200,False,6,10,4,200,False,True,200
LA1_1639037998,100,15637,16963,-1326,200,False,2,5,-3,200,False,False,200
LA1_1632308632,200,16812,17255,443,200,False,7,7,0,0,False,True,200
LA1_1637187832,200,16016,17038,1022,200,False,7,6,-1,100,True,True,200
LA1_1637463624,200,14036,18805,4769,200,False,2,11,9,200,False,True,200
LA1_1638805698,100,16663,16686,-23,200,False,4,6,-2,200,False,True,100
LA1_1633808080,100,16771,17486,-715,200,False,6,7,-1,200,False,True,100
LA1_1629619176,100,16925,16637,288,100,False,4,5,-1,200,False,True,100
LA1_1633383562,200,18251,17144,-1107,100,False,9,6,-3,100,True,False,100
LA1_1637022256,200,16518,16662,144,200,False,3,6,3,200,False,True,200
LA1_1635789521,200,16333,14637,-1696,100,False,5,2,-3,100,True,True,200
LA1_1640748058,100,15708,17335,-1627,200,False,3,6,-3,200,False,True,100
LA1_1635031792,100,15215,19713,-4498,200,False,4,13,-9,200,False,False,200
LA1_1631860788,100,19049,17922,1127,100,False,9,9,0,0,False,False,200
LA1_1638228553,100,14850,15608,-758,200,False,2,5,-3,200,False,True,100
LA1_1628704259,100,17045,14658,2387,100,False,5,3,2,100,True,True,100
LA1_1637893874,200,16371,15327,-1044,100,False,3,1,-2,100,True,False,100
LA1_1632132120,200,16108,18861,2753,200,False,5,10,5,200,False,True,200
LA1_1634393528,100,16549,16982,-433,200,False,6,6,0,0,False,False,200
LA1_1640309803,100,16691,14962,1729,100,False,6,3,3,100,True,True,100
LA1_1636493652,100,17825,16566,1259,100,False,9,4,5,100,True,True,100
LA1_1639512744,200,16404,17979,1575,200,False,7,7,0,0,False,False,100
LA1_1637573382,200,17367,17241,-126,100,False,8,6,-2,100,True,True,200
LA1_1637066102,100,16683,16669,14,100,False,9,8,1,100,True,True,100
LA1_1639599612,100,16170,17287,-1117,200,False,4,5,-1,200,False,False,200
LA1_1638114350,200,17421,17032,-389,100,False,6,6,0,0,False,False,100
LA1_1637690122,100,16476,15777,699,100,False,4,4,0,0,False,True,100
LA1_1637812828,100,18565,15130,3435,100,False,8,2,6,100,True,True,100
LA1_1638104078,200,16175,17364,1189,200,False,4,5,1,200,False,True,200
LA1_1636646758,200,18771,15189,-3582,100,False,10,4,-6,100,True,False,100
LA1_1640299048,100,17547,18010,-463,200,False,8,9,-1,200,False,True,100
LA1_1636411164,200,16728,17472,744,200,False,7,9,2,200,False,True,200
LA1_1639609946,200,16399,15740,-659,100,False,5,2,-3,100,True,True,200
LA1_1637800845,200,14826,17111,2285,200,False,2,7,5,200,False,True,200
LA1_1640389296,100,16171,18386,-2215,200,False,5,8,-3,200,False,False,200
LA1_1637863499,200,17945,14593,-3352,100,False,5,1,-4,100,True,False,100
LA1_1637591907,200,17133,14637,-2496,100,False,7,1,-6,100,True,True,200
LA1_1636253410,100,17556,18223,-667,200,False,7,9,-2,200,False,True,100
LA1_1638617913,100,15508,16295,-787,200,False,2,3,-1,200,False,False,200
LA1_1636400763,200,15972,20112,4140,200,False,4,14,10,200,False,True,200
LA1_1637079110,200,14763,16906,2143,200,False,2,6,4,200,False,True,200
LA1_1637714172,200,17838,15998,-1840,100,False,6,5,-1,100,True,False,100
LA1_1639527043,100,17193,18395,-1202,200,False,7,9,-2,200,False,False,200
LA1_1636663059,200,15988,17464,1476,200,False,4,6,2,200,False,True,200
LA1_1640158361,100,17216,16292,924,100,False,5,2,3,100,True,True,100
LA1_1640326935,200,15540,16552,1012,200,False,4,5,1,200,False,True,200
LA1_1637047886,100,17537,15416,2121,100,False,7,4,3,100,True,True,100
LA1_1637033306,100,15673,17654,-1981,200,False,5,11,-6,200,False,False,200
LA1_1637700999,100,18062,17872,190,100,False,8,8,0,0,False,False,200
LA1_1636241428,100,17641,17225,416,100,False,7,6,1,100,True,True,100
LA1_1640340413,200,15707,15197,-510,100,False,2,2,0,0,False,True,200
LA1_1636485553,200,15254,18770,3516,200,False,4,13,9,200,False,True,200
LA1_1637302323,100,16079,17715,-1636,200,False,5,9,-4,200,False,False,200
LA1_1636424047,100,16379,14948,1431,100,False,3,2,1,100,True,True,100
LA1_1639620482,100,19135,17643,1492,100,False,10,9,1,100,True,True,100
LA1_1640395675,200,17675,15236,-2439,100,False,8,4,-4,100,True,False,100
LA1_1637722672,200,17051,17149,98,200,False,7,6,-1,100,True,False,100
LA1_1637743403,100,18287,17785,502,100,False,9,6,3,100,True,True,100
LA1_1638864120,200,17267,18977,1710,200,False,8,10,2,200,False,True,200
LA1_1637583961,100,17715,18006,-291,200,False,8,10,-2,200,False,True,100
LA1_1638096293,100,20032,17607,2425,100,False,10,7,3,100,True,True,100
LA1_1640278387,200,16982,16240,-742,100,False,6,5,-1,100,True,False,100
LA1_1640456900,100,17579,15417,2162,100,False,8,2,6,100,True,True,100
LA1_1633078083,200,18491,15770,-2721,100,False,8,5,-3,100,True,False,100
LA1_1635483859,200,16987,18893,1906,200,False,7,11,4,200,False,False,100
LA1_1640525051,100,16710,17910,-1200,200,False,5,10,-5,200,False,False,200
LA1_1635727355,100,16308,17321,-1013,200,False,4,5,-1,200,False,False,200
LA1_1633247038,200,15011,20902,5891,200,False,4,12,8,200,False,True,200
LA1_1640246256,100,17568,16439,1129,100,False,7,4,3,100,True,True,100
LA1_1635489354,100,16216,19132,-2916,200,False,8,15,-7,200,False,False,200
LA1_1640542491,200,18009,16928,-1081,100,False,8,6,-2,100,True,False,100
LA1_1640367095,200,17879,18417,538,200,False,8,10,2,200,False,False,100
LA1_1636180916,100,18335,17692,643,100,False,9,9,0,0,False,False,200
LA1_1633555175,100,14456,16854,-2398,200,False,2,6,-4,200,False,False,200
LA1_1636168552,100,18037,18317,-280,200,False,8,9,-1,200,False,False,200
LA1_1639941862,200,17320,15653,-1667,100,False,6,3,-3,100,True,False,100
LA1_1635610315,200,17945,15228,-2717,100,False,7,2,-5,100,True,False,100
LA1_1633127560,200,16047,16810,763,200,False,3,6,3,200,False,True,200
LA1_1640433865,100,19452,19870,-418,200,False,11,8,3,100,True,False,200
LA1_1635345865,100,17716,18262,-546,200,False,9,12,-3,200,False,True,100
LA1_1633256412,100,17561,16226,1335,100,False,7,3,4,100,True,True,100
LA1_1632968388,100,16542,19508,-2966,200,False,6,7,-1,200,False,False,200
LA1_1634048199,200,15237,16819,1582,200,False,4,7,3,200,False,False,100
LA1_1633193064,100,16764,18077,-1313,200,False,6,7,-1,200,False,False,200
LA1_1633086222,100,17251,15131,2120,100,False,8,3,5,100,True,True,100
LA1_1633940787,100,18419,16195,2224,100,False,8,5,3,100,True,True,100
LA1_1633182610,100,17033,15725,1308,100,False,4,3,1,100,True,False,200
LA1_1633383615,200,15782,16123,341,200,False,2,3,1,200,False,True,200
LA1_1640377923,200,14930,16759,1829,200,False,2,4,2,200,False,True,200
LA1_1634003667,100,17645,16242,1403,100,False,7,5,2,100,True,False,200
LA1_1635667362,100,18602,16743,1859,100,False,9,5,4,100,True,False,200
LA1_1635645640,200,16140,19152,3012,200,False,7,10,3,200,False,True,200
LA1_1635595948,100,16491,17183,-692,200,False,3,4,-1,200,False,True,100
LA1_1635617678,200,17361,16716,-645,100,False,6,4,-2,100,True,False,100
LA1_1633955415,100,15128,18166,-3038,200,False,2,9,-7,200,False,False,200
LA1_1634041133,100,14339,18751,-4412,200,False,1,8,-7,200,False,False,200
LA1_1634004063,200,17498,18866,1368,200,False,8,11,3,200,False,False,100
LA1_1633378360,100,16067,16961,-894,200,False,2,7,-5,200,False,False,200
LA1_1635320504,100,14496,17943,-3447,200,False,2,6,-4,200,False,True,100
LA1_1640372034,200,16744,15369,-1375,100,False,5,2,-3,100,True,True,200
LA1_1635008089,200,17706,15658,-2048,100,False,7,3,-4,100,True,False,100
LA1_1636081683,200,17479,18015,536,200,False,8,10,2,200,False,False,100
LA1_1633277253,100,16731,16925,-194,200,False,5,5,0,0,False,False,200
LA1_1635725143,100,18356,14669,3687,100,False,8,1,7,100,True,True,100
LA1_1635517621,100,15071,17074,-2003,200,False,2,7,-5,200,False,False,200
LA1_1635633025,200,15824,16467,643,200,False,3,4,1,200,False,False,100
LA1_1643165305,200,17991,15316,-2675,100,False,6,2,-4,100,True,False,100
LA1_1640069382,100,16195,15620,575,100,False,5,4,1,100,True,True,100
LA1_1643562108,100,20238,16405,3833,100,False,11,6,5,100,True,True,100
LA1_1635644033,200,17899,15292,-2607,100,False,7,3,-4,100,True,False,100
LA1_1635625910,100,15694,18835,-3141,200,False,4,10,-6,200,False,False,200
LA1_1638605952,100,17263,18561,-1298,200,False,7,8,-1,200,False,True,100
LA1_1641170880,100,16033,15816,217,100,False,3,5,-2,200,False,False,200
LA1_1638823300,200,16637,17438,801,200,False,5,7,2,200,False,True,200
LA1_1637760000,200,15843,15098,-745,100,False,3,4,1,200,False,True,200
LA1_1642821402,200,15210,19002,3792,200,False,4,11,7,200,False,True,200
LA1_1642814588,200,16556,14888,-1668,100,False,5,3,-2,100,True,False,100
LA1_1639910327,100,16751,16668,83,100,False,6,4,2,100,True,True,100
LA1_1635579809,200,16203,16335,132,200,False,6,4,-2,100,True,True,200
LA1_1642800518,200,17882,19367,1485,200,False,10,11,1,200,False,False,100
LA1_1637223443,200,15718,16711,993,200,False,4,7,3,200,False,False,100
LA1_1639523702,200,17061,16349,-712,100,False,7,6,-1,100,True,False,100
LA1_1635819582,200,16427,13416,-3011,100,False,4,0,-4,100,True,False,100
LA1_1634661054,200,16671,16968,297,200,False,5,5,0,0,False,True,200
LA1_1640929209,200,15841,17983,2142,200,False,5,11,6,200,False,False,100
LA1_1641177034,100,18811,14260,4551,100,False,9,1,8,100,True,True,100
LA1_1633802998,200,17801,17327,-474,100,False,9,7,-2,100,True,False,100
LA1_1633888776,200,21208,16594,-4614,100,False,15,5,-10,100,True,False,100
LA1_1634085468,100,16938,17820,-882,200,False,6,10,-4,200,False,False,200
LA1_1635009357,100,15377,15659,-282,200,False,4,5,-1,200,False,False,200
LA1_1633218242,200,17205,14983,-2222,100,False,7,2,-5,100,True,False,100
LA1_1633351548,100,17023,17572,-549,200,False,6,6,0,0,False,False,200
LA1_1633787119,100,19011,15193,3818,100,False,9,3,6,100,True,True,100
LA1_1633791196,100,18739,16468,2271,100,False,10,4,6,100,True,True,100
LA1_1633604798,100,15086,16213,-1127,200,False,2,7,-5,200,False,False,200
LA1_1637007874,200,18178,19098,920,200,False,10,11,1,200,False,False,100
LA1_1635019150,200,17073,17007,-66,100,False,7,5,-2,100,True,False,100
LA1_1633781425,200,18756,16556,-2200,100,False,9,5,-4,100,True,False,100
LA1_1634341976,200,16627,20092,3465,200,False,6,17,11,200,False,True,200
LA1_1633358321,200,17330,18747,1417,200,False,5,8,3,200,False,True,200
LA1_1634016115,100,17797,17094,703,100,False,8,9,-1,200,False,True,100
LA1_1634183848,200,18907,18020,-887,100,False,13,9,-4,100,True,True,200
LA1_1634200572,100,17932,15487,2445,100,False,10,2,8,100,True,True,100
LA1_1633399842,200,18248,18356,108,200,False,8,10,2,200,False,False,100
LA1_1637000222,100,18694,15817,2877,100,False,9,2,7,100,True,False,200
LA1_1637236414,100,18015,16542,1473,100,False,6,5,1,100,True,False,200
LA1_1633651298,200,14780,16489,1709,200,False,1,3,2,200,False,True,200
LA1_1635002324,100,16532,15491,1041,100,False,4,2,2,100,True,False,200
LA1_1633898033,100,16274,19647,-3373,200,False,5,11,-6,200,False,False,200
LA1_1634008668,100,17388,17100,288,100,False,8,5,3,100,True,True,100
LA1_1634004916,100,16146,16968,-822,200,False,4,7,-3,200,False,False,200
LA1_1633364814,100,17427,17091,336,100,False,9,8,1,100,True,True,100
LA1_1633374323,100,17279,14383,2896,100,False,8,2,6,100,True,True,100
LA1_1633594875,200,17273,17807,534,200,False,8,7,-1,100,True,False,100
LA1_1633412310,100,18259,18285,-26,200,False,10,9,1,100,True,True,100
LA1_1637225861,100,16457,16597,-140,200,False,4,8,-4,200,False,True,100
LA1_1633776611,200,18133,15410,-2723,100,False,8,3,-5,100,True,False,100
LA1_1633394583,200,18253,18267,14,200,False,7,8,1,200,False,False,100
LA1_1635028231,100,17584,18268,-684,200,False,9,10,-1,200,False,True,100
LA1_1634688554,200,16537,17483,946,200,False,5,9,4,200,False,True,200
LA1_1633516838,100,16872,17489,-617,200,False,6,9,-3,200,False,True,100
LA1_1638854574,200,18347,15772,-2575,100,False,9,4,-5,100,True,False,100
LA1_1628010375,200,16810,16104,-706,100,False,6,5,-1,100,True,True,200
LA1_1640486640,200,16277,15288,-989,100,False,6,4,-2,100,True,True,200
LA1_1633075138,100,16666,18300,-1634,200,False,6,8,-2,200,False,False,200
LA1_1640285768,100,18833,15439,3394,100,False,10,2,8,100,True,True,100
LA1_1631992082,200,15747,15471,-276,100,False,3,2,-1,100,True,True,200
LA1_1634654453,200,17763,16300,-1463,100,False,8,5,-3,100,True,True,200
LA1_1628064835,100,18506,18125,381,100,False,10,9,1,100,True,True,100
LA1_1639467541,200,16444,19661,3217,200,False,6,11,5,200,False,True,200
LA1_1638870284,100,15495,16303,-808,200,False,2,4,-2,200,False,True,100
LA1_1636398253,200,15616,16501,885,200,False,4,6,2,200,False,True,200
LA1_1628080665,100,16962,18399,-1437,200,False,7,10,-3,200,False,True,100
LA1_1636414523,100,15757,18312,-2555,200,False,5,9,-4,200,False,False,200
LA1_1634672539,200,18340,16123,-2217,100,False,9,5,-4,100,True,True,200
LA1_1629539312,100,17332,15772,1560,100,False,7,3,4,100,True,True,100
LA1_1633098976,100,16671,18467,-1796,200,False,5,11,-6,200,False,False,200
LA1_1637213100,100,16071,16079,-8,200,False,4,4,0,0,False,True,100
LA1_1634631221,100,15985,18161,-2176,200,False,5,9,-4,200,False,True,100
LA1_1636376013,200,16091,16659,568,200,False,5,7,2,200,False,True,200
LA1_1633506016,100,16812,16627,185,100,False,6,6,0,0,False,True,100
LA1_1634711762,200,17972,17656,-316,100,False,8,9,1,200,False,False,100
LA1_1633536012,200,18959,15388,-3571,100,False,9,3,-6,100,True,False,100
LA1_1635585430,100,17492,17236,256,100,False,9,7,2,100,True,True,100
LA1_1639534678,100,18178,15963,2215,100,False,7,5,2,100,True,True,100
LA1_1637243392,200,15334,18724,3390,200,False,2,10,8,200,False,True,200
LA1_1631980917,200,17912,17139,-773,100,False,7,7,0,0,False,False,100
LA1_1634699881,100,15812,16474,-662,200,False,4,4,0,0,False,True,100
LA1_1631739346,200,16936,16493,-443,100,False,6,3,-3,100,True,False,100
LA1_1638828546,100,18095,15207,2888,100,False,10,2,8,100,True,True,100
LA1_1637205219,100,17576,15392,2184,100,False,9,4,5,100,True,True,100
LA1_1635579318,100,15848,17050,-1202,200,False,3,4,-1,200,False,False,200
LA1_1629544908,100,18548,15657,2891,100,False,11,4,7,100,True,True,100
LA1_1631997403,200,15038,19803,4765,200,False,3,12,9,200,False,True,200
LA1_1628040079,100,17569,14572,2997,100,False,8,2,6,100,True,True,100
LA1_1628054359,200,20072,15881,-4191,100,False,15,7,-8,100,True,False,100
LA1_1633024907,200,15873,18599,2726,200,False,5,11,6,200,False,True,200
LA1_1638306217,100,16232,17082,-850,200,False,2,6,-4,200,False,False,200
LA1_1638319177,200,18075,16064,-2011,100,False,10,3,-7,100,True,False,100
LA1_1637231212,100,18394,19121,-727,200,False,11,15,-4,200,False,True,100
LA1_1631998872,100,16283,15593,690,100,False,4,5,-1,200,False,True,100
LA1_1633652316,100,19363,15588,3775,100,False,11,5,6,100,True,True,100
LA1_1634369807,100,17103,17188,-85,200,False,9,8,1,100,True,True,100
LA1_1634382389,200,17563,18463,900,200,False,8,9,1,200,False,False,100
LA1_1634847398,100,19936,16674,3262,100,False,11,6,5,100,True,False,200
LA1_1634591890,100,17973,16679,1294,100,False,9,6,3,100,True,True,100
LA1_1640174936,100,14282,17648,-3366,200,False,3,6,-3,200,False,False,200
LA1_1635158575,200,16444,15694,-750,100,False,4,1,-3,100,True,True,200
LA1_1633690242,200,18655,19750,1095,200,False,8,14,6,200,False,True,200
LA1_1636568477,200,17200,16254,-946,100,False,8,4,-4,100,True,True,200
LA1_1635128669,100,16355,18072,-1717,200,False,5,11,-6,200,False,True,100
LA1_1640199456,200,17635,17605,-30,100,False,11,8,-3,100,True,False,100
LA1_1635113517,100,16186,15685,501,100,False,4,4,0,0,False,True,100
LA1_1634465088,200,17574,15791,-1783,100,False,9,3,-6,100,True,False,100
LA1_1634806608,200,20838,16257,-4581,100,False,16,4,-12,100,True,False,100
LA1_1634393637,100,20295,17475,2820,100,False,13,9,4,100,True,True,100
LA1_1639699261,100,15369,19051,-3682,200,False,5,10,-5,200,False,False,200
LA1_1634075389,100,17437,16704,733,100,False,8,5,3,100,True,True,100
LA1_1640828621,200,15395,18021,2626,200,False,3,8,5,200,False,True,200
LA1_1627720946,100,16827,17225,-398,200,False,7,9,-2,200,False,True,100
LA1_1634030627,100,16860,14709,2151,100,False,8,2,6,100,True,True,100
LA1_1628480269,100,17096,16044,1052,100,False,8,4,4,100,True,True,100
LA1_1633144661,200,16828,16744,-84,100,False,5,6,1,200,False,False,100
LA1_1636751852,200,16886,17971,1085,200,False,6,7,1,200,False,True,200
LA1_1637397903,100,17947,15888,2059,100,False,8,3,5,100,True,True,100
LA1_1635824695,200,19440,17913,-1527,100,False,12,7,-5,100,True,False,100
LA1_1634642131,200,16299,17154,855,200,False,4,6,2,200,False,False,100
LA1_1629116491,200,18309,17447,-862,100,False,10,7,-3,100,True,False,100
LA1_1632616887,100,17519,18043,-524,200,False,9,8,1,100,True,False,200
LA1_1634114156,200,17803,15763,-2040,100,False,8,3,-5,100,True,False,100
LA1_1639982259,100,17447,15219,2228,100,False,6,2,4,100,True,True,100
LA1_1633136122,100,17787,16401,1386,100,False,7,5,2,100,True,True,100
LA1_1638176537,200,15665,16869,1204,200,False,4,4,0,0,False,True,200
LA1_1636574421,200,16791,17510,719,200,False,5,7,2,200,False,True,200
LA1_1639377811,200,14927,17325,2398,200,False,3,7,4,200,False,False,100
LA1_1641094039,100,16596,15300,1296,100,False,4,4,0,0,False,True,100
LA1_1641108873,100,15264,17300,-2036,200,False,3,6,-3,200,False,False,200
LA1_1634394813,100,17563,16122,1441,100,False,7,5,2,100,True,True,100
LA1_1640509990,100,17046,18546,-1500,200,False,5,10,-5,200,False,False,200
LA1_1631903282,200,16153,15278,-875,100,False,4,2,-2,100,True,False,100
LA1_1634624162,100,17107,17836,-729,200,False,5,7,-2,200,False,False,200
LA1_1631058245,100,16362,16127,235,100,False,6,4,2,100,True,False,200
LA1_1636106699,100,16403,15683,720,100,False,4,3,1,100,True,False,200
LA1_1630793170,200,21006,19408,-1598,100,False,14,12,-2,100,True,True,200
LA1_1629072926,100,18243,16290,1953,100,False,7,6,1,100,True,True,100
LA1_1634061857,200,16077,17099,1022,200,False,5,7,2,200,False,True,200
LA1_1629673046,200,15155,18994,3839,200,False,3,12,9,200,False,True,200
LA1_1637449334,100,14460,16964,-2504,200,False,1,7,-6,200,False,False,200
LA1_1640240013,100,17302,16584,718,100,False,9,7,2,100,True,True,100
LA1_1634124520,200,17223,16008,-1215,100,False,6,2,-4,100,True,False,100
LA1_1636807933,100,15769,16337,-568,200,False,3,4,-1,200,False,True,100
LA1_1633138878,100,15694,16249,-555,200,False,3,2,1,100,True,False,200
LA1_1632805931,100,16789,16009,780,100,False,6,6,0,0,False,False,200
LA1_1631254000,100,15889,16614,-725,200,False,5,6,-1,200,False,False,200
LA1_1639111892,100,18440,17649,791,100,False,10,6,4,100,True,True,100
LA1_1628467367,200,16398,14293,-2105,100,False,5,2,-3,100,True,False,100
LA1_1632059571,100,16544,17920,-1376,200,False,5,9,-4,200,False,True,100
LA1_1632493704,100,17195,17024,171,100,False,7,7,0,0,False,False,200
LA1_1632046258,100,19777,14444,5333,100,False,14,3,11,100,True,True,100
LA1_1637427213,100,14812,18593,-3781,200,False,3,11,-8,200,False,False,200
LA1_1636023407,200,16055,17636,1581,200,False,5,6,1,200,False,False,100
LA1_1637466948,200,15218,18442,3224,200,False,2,10,8,200,False,True,200
LA1_1636058541,100,18555,15962,2593,100,False,8,5,3,100,True,True,100
LA1_1632473464,200,17520,18094,574,200,False,8,11,3,200,False,False,100
LA1_1632032753,100,15964,17094,-1130,200,False,4,7,-3,200,False,False,200
LA1_1636979801,100,17687,15879,1808,100,False,7,3,4,100,True,True,100
LA1_1637447087,100,19745,18304,1441,100,False,12,9,3,100,True,True,100
LA1_1637411004,100,17351,15471,1880,100,False,8,3,5,100,True,True,100
LA1_1637455899,200,17885,18587,702,200,False,7,9,2,200,False,True,200
LA1_1632490454,200,17063,14894,-2169,100,False,6,2,-4,100,True,False,100
LA1_1633699072,200,16785,16728,-57,100,False,6,6,0,0,False,True,200
LA1_1636032360,100,17313,14922,2391,100,False,7,3,4,100,True,True,100
LA1_1632641827,100,15901,16384,-483,200,False,2,3,-1,200,False,True,100
LA1_1632619946,100,17617,17186,431,100,False,6,5,1,100,True,True,100
LA1_1637279232,100,15175,16257,-1082,200,False,1,4,-3,200,False,False,200
LA1_1632018069,100,16323,17472,-1149,200,False,5,7,-2,200,False,True,100
LA1_1632465747,200,17513,14713,-2800,100,False,8,3,-5,100,True,False,100
LA1_1632009132,200,18384,14449,-3935,100,False,10,3,-7,100,True,False,100
LA1_1632478722,200,16055,14989,-1066,100,False,4,2,-2,100,True,False,100
LA1_1638136972,200,15774,15513,-261,100,False,3,3,0,0,False,True,200
LA1_1636763447,200,16477,16058,-419,100,False,4,1,-3,100,True,False,100
LA1_1636946218,100,17314,14968,2346,100,False,8,3,5,100,True,True,100
LA1_1634081883,200,16391,17112,721,200,False,6,8,2,200,False,False,100
LA1_1635599713,200,15905,15558,-347,100,False,4,4,0,0,False,True,200
LA1_1628967316,200,15935,19229,3294,200,False,6,7,1,200,False,False,100
LA1_1640003806,200,16531,15573,-958,100,False,4,3,-1,100,True,False,100
LA1_1636833370,200,18253,15048,-3205,100,False,9,4,-5,100,True,False,100
LA1_1632857717,200,15759,17139,1380,200,False,2,6,4,200,False,True,200
LA1_1628908139,200,18626,16679,-1947,100,False,9,4,-5,100,True,False,100
LA1_1628194373,100,16365,15465,900,100,False,4,1,3,100,True,True,100
LA1_1629617442,200,15784,17139,1355,200,False,5,8,3,200,False,True,200
LA1_1638800592,100,16196,15541,655,100,False,4,3,1,100,True,True,100
LA1_1636537435,100,18310,18590,-280,200,False,8,10,-2,200,False,True,100
LA1_1633867371,200,16427,13811,-2616,100,False,7,1,-6,100,True,False,100
LA1_1639747661,200,17989,15757,-2232,100,False,9,5,-4,100,True,True,200
LA1_1632159955,200,15423,18244,2821,200,False,4,9,5,200,False,True,200
LA1_1628982704,200,16808,16842,34,200,False,4,5,1,200,False,False,100
LA1_1632492855,200,17797,14896,-2901,100,False,8,2,-6,100,True,True,200
LA1_1627539809,200,16734,17979,1245,200,False,6,8,2,200,False,False,100
LA1_1632968105,200,14963,17030,2067,200,False,2,6,4,200,False,False,100
LA1_1629631799,200,15224,16516,1292,200,False,3,4,1,200,False,True,200
LA1_1636918605,100,16500,16023,477,100,False,4,3,1,100,True,False,200
LA1_1632499990,200,16908,15140,-1768,100,False,7,2,-5,100,True,True,200
LA1_1634130339,100,16885,16715,170,100,False,8,5,3,100,True,False,200
LA1_1632409023,100,15746,17370,-1624,200,False,5,5,0,0,False,True,100
LA1_1636921931,100,16261,17047,-786,200,False,4,4,0,0,False,False,200
LA1_1632365499,200,18594,17300,-1294,100,False,8,9,1,200,False,True,200
LA1_1636935075,100,15927,15539,388,100,False,4,3,1,100,True,True,100
LA1_1628185122,100,16365,15567,798,100,False,5,4,1,100,True,False,200
LA1_1628200526,200,17012,17806,794,200,False,9,7,-2,100,True,True,200
LA1_1633088191,200,18136,17325,-811,100,False,10,7,-3,100,True,True,200
LA1_1628164002,200,15688,16667,979,200,False,3,3,0,0,False,True,200
LA1_1633063946,100,18784,15753,3031,100,False,9,3,6,100,True,True,100
LA1_1640573832,100,16992,15906,1086,100,False,4,6,-2,200,False,False,200
LA1_1636928686,100,16462,19145,-2683,200,False,4,10,-6,200,False,False,200
LA1_1632390497,100,19002,18357,645,100,False,10,8,2,100,True,False,200
LA1_1629626048,200,15190,18897,3707,200,False,2,8,6,200,False,True,200
LA1_1633034784,200,16722,16820,98,200,False,5,5,0,0,False,False,100
LA1_1634098782,200,17622,17656,34,200,False,6,7,1,200,False,False,100
LA1_1633045501,200,16167,18834,2667,200,False,6,11,5,200,False,True,200
LA1_1628172950,100,17099,17305,-206,200,False,5,7,-2,200,False,True,100
LA1_1628168356,200,17477,17212,-265,100,False,9,3,-6,100,True,False,100
LA1_1637309670,200,15902,17207,1305,200,False,6,5,-1,100,True,True,200
LA1_1634205093,200,18705,16446,-2259,100,False,10,8,-2,100,True,False,100
LA1_1635682181,100,16732,17101,-369,200,False,4,7,-3,200,False,False,200
LA1_1635584429,200,17137,17382,245,200,False,6,6,0,0,False,True,200
LA1_1635224118,200,18680,16954,-1726,100,False,10,6,-4,100,True,True,200
LA1_1635980017,100,18213,17907,306,100,False,9,8,1,100,True,True,100
LA1_1632175381,100,17496,16535,961,100,False,7,5,2,100,True,True,100
LA1_1632400994,100,17243,16874,369,100,False,7,6,1,100,True,False,200
LA1_1634678064,200,18120,18526,406,200,False,8,11,3,200,False,True,200
LA1_1633261611,100,17857,16987,870,100,False,7,4,3,100,True,True,100
LA1_1637335886,200,16154,17276,1122,200,False,5,6,1,200,False,True,200
LA1_1635443877,100,14788,15806,-1018,200,False,2,4,-2,200,False,False,200
LA1_1635941382,200,17637,14868,-2769,100,False,7,2,-5,100,True,True,200
LA1_1635454583,200,16872,16343,-529,100,False,6,4,-2,100,True,False,100
LA1_1635161553,200,16758,20402,3644,200,False,7,14,7,200,False,False,100
LA1_1632658412,200,16989,15917,-1072,100,False,7,4,-3,100,True,False,100
LA1_1633714339,200,17389,16688,-701,100,False,6,7,1,200,False,False,100
LA1_1635548269,200,16193,15312,-881,100,False,5,6,1,200,False,True,200
LA1_1635976273,200,16201,15219,-982,100,False,4,4,0,0,False,False,100
LA1_1635525154,100,15953,17752,-1799,200,False,3,9,-6,200,False,False,200
LA1_1635457510,200,17764,18647,883,200,False,8,11,3,200,False,True,200
LA1_1635573035,200,17005,15049,-1956,100,False,9,4,-5,100,True,True,200
LA1_1635434914,100,16332,15412,920,100,False,4,4,0,0,False,False,200
LA1_1631940930,100,16221,17000,-779,200,False,3,6,-3,200,False,True,100
LA1_1637283741,100,17646,18837,-1191,200,False,7,11,-4,200,False,False,200
LA1_1634653139,200,16151,18135,1984,200,False,8,9,1,200,False,True,200
LA1_1635659506,100,17821,17940,-119,200,False,9,12,-3,200,False,False,200
LA1_1635962539,100,15337,15054,283,100,False,3,2,1,100,True,True,100
LA1_1635970580,100,15423,16115,-692,200,False,3,5,-2,200,False,True,100
LA1_1637353328,200,15730,17354,1624,200,False,2,6,4,200,False,True,200
LA1_1633944134,100,16175,15608,567,100,False,4,4,0,0,False,False,200
LA1_1633507842,200,17574,18551,977,200,False,7,11,4,200,False,True,200
LA1_1637330348,100,16736,14770,1966,100,False,4,4,0,0,False,True,100
LA1_1635536831,200,16916,19128,2212,200,False,7,11,4,200,False,False,100
LA1_1635218976,200,17787,15314,-2473,100,False,7,5,-2,100,True,False,100
LA1_1635561407,200,18072,19127,1055,200,False,9,10,1,200,False,False,100
LA1_1634391776,100,18061,17886,175,100,False,7,8,-1,200,False,False,200
LA1_1637357128,100,19104,16070,3034,100,False,11,5,6,100,True,True,100
LA1_1635458991,200,19987,14226,-5761,100,False,13,2,-11,100,True,False,100
LA1_1635693923,100,17787,16608,1179,100,False,8,5,3,100,True,True,100
LA1_1637300146,200,15975,15563,-412,100,False,4,2,-2,100,True,False,100
LA1_1635603920,200,16133,16777,644,200,False,5,7,2,200,False,False,100
LA1_1630424902,200,14408,17217,2809,200,False,2,7,5,200,False,True,200
LA1_1635152843,200,15514,16800,1286,200,False,3,5,2,200,False,True,200
LA1_1629997520,200,14058,19376,5318,200,False,0,8,8,200,False,True,200
LA1_1639441188,200,16001,18233,2232,200,False,3,8,5,200,False,True,200
LA1_1642520573,200,16756,18865,2109,200,False,7,12,5,200,False,False,100
LA1_1641527806,100,16402,15284,1118,100,False,5,2,3,100,True,False,200
LA1_1641065099,100,14924,17062,-2138,200,False,3,8,-5,200,False,False,200
LA1_1640502849,100,19284,15731,3553,100,False,11,6,5,100,True,True,100
LA1_1641501111,200,18653,16871,-1782,100,False,8,6,-2,100,True,True,200
LA1_1640684438,200,14577,19320,4743,200,False,2,15,13,200,False,False,100
LA1_1641814344,100,18671,15402,3269,100,False,10,5,5,100,True,False,200
LA1_1640103871,100,17996,16380,1616,100,False,10,4,6,100,True,True,100
LA1_1642043525,200,16058,19927,3869,200,False,4,16,12,200,False,True,200
LA1_1641762450,100,18445,15903,2542,100,False,9,6,3,100,True,True,100
LA1_1641841939,200,15287,17947,2660,200,False,4,10,6,200,False,True,200
LA1_1641047142,100,17019,19065,-2046,200,False,10,13,-3,200,False,False,200
LA1_1640698900,200,17051,17786,735,200,False,6,6,0,0,False,True,200
LA1_1642268795,100,17745,18744,-999,200,False,8,12,-4,200,False,False,200
LA1_1641516224,200,16487,18102,1615,200,False,6,10,4,200,False,True,200
LA1_1641031281,200,16953,15554,-1399,100,False,6,3,-3,100,True,False,100
LA1_1642573251,200,16886,16925,39,200,False,6,7,1,200,False,False,100
LA1_1642056539,100,16011,16613,-602,200,False,4,5,-1,200,False,True,100
LA1_1640387822,100,16872,16798,74,100,False,5,4,1,100,True,False,200
LA1_1642528474,200,16442,15895,-547,100,False,4,4,0,0,False,True,200
LA1_1641246847,200,19270,18040,-1230,100,False,11,8,-3,100,True,False,100
LA1_1640662513,200,14866,19167,4301,200,False,3,11,8,200,False,True,200
LA1_1641829471,200,17380,14792,-2588,100,False,7,2,-5,100,True,False,100
LA1_1641257670,100,18358,16844,1514,100,False,11,7,4,100,True,True,100
LA1_1642281499,100,16771,15337,1434,100,False,5,3,2,100,True,True,100
LA1_1640112540,200,16792,19073,2281,200,False,7,13,6,200,False,True,200
LA1_1639930609,200,17746,15467,-2279,100,False,9,4,-5,100,True,True,200
LA1_1640924944,100,16901,16538,363,100,False,8,5,3,100,True,False,200
LA1_1641288892,100,17443,16362,1081,100,False,8,4,4,100,True,False,200
LA1_1641802273,100,18023,16052,1971,100,False,10,6,4,100,True,False,200
LA1_1641753339,200,15359,15425,66,200,False,3,4,1,200,False,False,100
LA1_1642552765,200,17237,16709,-528,100,False,6,5,-1,100,True,False,100
LA1_1641230485,200,16533,18317,1784,200,False,6,11,5,200,False,True,200
LA1_1642259145,100,19094,14689,4405,100,False,8,3,5,100,True,True,100
LA1_1641786271,100,16455,14729,1726,100,False,8,4,4,100,True,True,100
LA1_1642545139,200,17287,16649,-638,100,False,6,4,-2,100,True,False,100
LA1_1641364526,100,17321,18646,-1325,200,False,6,10,-4,200,False,True,100
LA1_1640672675,100,17917,18707,-790,200,False,10,9,1,100,True,False,200
LA1_1641218323,200,15431,16341,910,200,False,1,5,4,200,False,True,200
LA1_1641775583,200,18267,17480,-787,100,False,9,8,-1,100,True,False,100
LA1_1643537855,200,16194,19149,2955,200,False,5,13,8,200,False,False,100
LA1_1638923762,100,15588,17130,-1542,200,False,2,4,-2,200,False,False,200
LA1_1643636365,200,16773,16709,-64,100,False,5,7,2,200,False,True,200
LA1_1643116961,200,18066,18734,668,200,False,9,8,-1,100,True,False,100
LA1_1643022430,200,17566,17769,203,200,False,8,5,-3,100,True,False,100
LA1_1643406964,200,15537,17855,2318,200,False,5,10,5,200,False,True,200
LA1_1643535077,100,17901,15089,2812,100,False,9,4,5,100,True,False,200
LA1_1643306654,200,16264,15583,-681,100,False,6,4,-2,100,True,False,100
LA1_1643643615,200,16132,17739,1607,200,False,4,8,4,200,False,False,100
LA1_1643316917,200,18707,15930,-2777,100,False,9,3,-6,100,True,True,200
LA1_1641792778,200,17345,15547,-1798,100,False,8,5,-3,100,True,False,100
LA1_1641463945,200,16196,15755,-441,100,False,6,4,-2,100,True,False,100
LA1_1638238167,200,15642,19891,4249,200,False,4,12,8,200,False,True,200
LA1_1641840344,100,14497,15914,-1417,200,False,2,2,0,0,False,False,200
LA1_1643368072,100,15212,18448,-3236,200,False,4,9,-5,200,False,False,200
LA1_1643326035,200,15808,17171,1363,200,False,4,7,3,200,False,True,200
LA1_1643133994,100,16173,15983,190,100,False,5,5,0,0,False,True,100
LA1_1643104461,200,17641,16339,-1302,100,False,8,4,-4,100,True,False,100
LA1_1643072662,100,18451,17489,962,100,False,12,7,5,100,True,True,100
LA1_1641783855,100,17022,16655,367,100,False,7,5,2,100,True,True,100
LA1_1643398457,100,17578,17938,-360,200,False,6,9,-3,200,False,False,200
LA1_1641854392,100,15697,15414,283,100,False,2,2,0,0,False,True,100
LA1_1643344221,100,15609,19185,-3576,200,False,4,11,-7,200,False,False,200
LA1_1643540733,200,15397,18774,3377,200,False,3,9,6,200,False,True,200
LA1_1641461538,200,14868,14869,1,200,False,3,3,0,0,False,False,100
LA1_1638918231,200,15157,16981,1824,200,False,3,5,2,200,False,True,200
LA1_1643385690,100,15728,19450,-3722,200,False,4,12,-8,200,False,False,200
LA1_1640843142,100,17955,14487,3468,100,False,5,1,4,100,True,True,100
LA1_1642042084,100,18046,17073,973,100,False,10,5,5,100,True,True,100
LA1_1640267515,100,17221,17840,-619,200,False,8,8,0,0,False,True,100
LA1_1629811630,100,17283,18689,-1406,200,False,8,13,-5,200,False,True,100
LA1_1635474729,200,15138,16884,1746,200,False,2,6,4,200,False,True,200
LA1_1636686898,100,15863,18435,-2572,200,False,6,10,-4,200,False,True,100
LA1_1632954658,200,15836,21012,5176,200,False,5,13,8,200,False,True,200
LA1_1640853163,100,16691,18937,-2246,200,False,6,13,-7,200,False,False,200
LA1_1636602408,200,18270,18886,616,200,False,9,8,-1,100,True,False,100
LA1_1635990922,100,17707,17732,-25,200,False,9,7,2,100,True,True,100
LA1_1635484243,200,16301,15934,-367,100,False,5,4,-1,100,True,False,100
LA1_1637717326,100,17774,15431,2343,100,False,7,3,4,100,True,True,100
LA1_1637427956,100,19151,19797,-646,200,False,11,13,-2,200,False,False,200
LA1_1629603680,100,16408,16295,113,100,False,3,5,-2,200,False,True,100
LA1_1636711302,200,15636,19493,3857,200,False,3,8,5,200,False,True,200
LA1_1635937483,100,16856,16481,375,100,False,5,3,2,100,True,False,200
LA1_1633137288,100,18356,17867,489,100,False,7,8,-1,200,False,False,200
LA1_1637440636,200,16939,17361,422,200,False,7,5,-2,100,True,True,200
LA1_1634738141,100,17504,16937,567,100,False,8,6,2,100,True,False,200
LA1_1634736359,200,15097,18515,3418,200,False,4,11,7,200,False,True,200
LA1_1637419642,200,18939,17763,-1176,100,False,11,7,-4,100,True,True,200
LA1_1640557625,100,18381,15524,2857,100,False,11,5,6,100,True,True,100
LA1_1633162068,200,16117,14301,-1816,100,False,3,0,-3,100,True,False,100
LA1_1634348422,100,17699,17155,544,100,False,9,7,2,100,True,True,100
LA1_1629593019,200,18088,19168,1080,200,False,7,11,4,200,False,True,200
LA1_1629597022,200,18339,17575,-764,100,False,10,9,-1,100,True,False,100
LA1_1639024646,200,16897,17659,762,200,False,5,7,2,200,False,True,200
LA1_1639611360,200,15570,17948,2378,200,False,4,8,4,200,False,True,200
LA1_1635995892,100,16584,16699,-115,200,False,6,6,0,0,False,False,200
LA1_1640693364,200,16910,15766,-1144,100,False,6,4,-2,100,True,False,100
LA1_1636895744,100,15942,18942,-3000,200,False,5,10,-5,200,False,False,200
LA1_1637983288,200,15257,15422,165,200,False,3,3,0,0,False,False,100
LA1_1636893515,100,14917,16109,-1192,200,False,3,4,-1,200,False,False,200
LA1_1636679423,200,17258,17268,10,200,False,10,8,-2,100,True,True,200
LA1_1637909214,100,15969,18122,-2153,200,False,4,7,-3,200,False,True,100
LA1_1641959899,100,17067,16847,220,100,False,5,6,-1,200,False,False,200
LA1_1637102794,100,17241,17522,-281,200,False,8,7,1,100,True,False,200
LA1_1637309047,200,17087,16012,-1075,100,False,7,6,-1,100,True,True,200
LA1_1641951780,200,14198,16694,2496,200,False,0,3,3,200,False,True,200
LA1_1636675852,200,15335,16773,1438,200,False,4,7,3,200,False,False,100
LA1_1636283917,200,16346,17104,758,200,False,5,8,3,200,False,True,200
LA1_1636884849,200,15846,16317,471,200,False,3,5,2,200,False,True,200
LA1_1637123914,200,16423,16091,-332,100,False,3,3,0,0,False,False,100
LA1_1637114054,200,15401,16668,1267,200,False,4,6,2,200,False,True,200
LA1_1636441665,200,17020,16133,-887,100,False,6,4,-2,100,True,True,200
LA1_1637970934,200,15165,16764,1599,200,False,1,4,3,200,False,True,200
LA1_1636677356,100,17622,16198,1424,100,False,8,6,2,100,True,True,100
LA1_1636878290,100,15812,17896,-2084,200,False,5,7,-2,200,False,False,200
LA1_1637829829,200,18613,14838,-3775,100,False,7,1,-6,100,True,False,100
LA1_1637321383,100,17141,15137,2004,100,False,5,1,4,100,True,True,100
LA1_1637288057,200,15402,15512,110,200,False,3,3,0,0,False,False,100
LA1_1636205232,100,17023,17064,-41,200,False,6,6,0,0,False,True,100
LA1_1641928675,100,17297,15087,2210,100,False,5,2,3,100,True,True,100
LA1_1637949889,200,18539,16774,-1765,100,False,10,7,-3,100,True,False,100
LA1_1636432356,100,16102,15392,710,100,False,4,2,2,100,True,True,100
LA1_1637130293,200,16964,14872,-2092,100,False,7,2,-5,100,True,False,100
LA1_1641939514,200,16638,14321,-2317,100,False,4,2,-2,100,True,False,100
LA1_1637824035,100,15757,17436,-1679,200,False,3,5,-2,200,False,True,100
LA1_1638009100,100,15772,17303,-1531,200,False,5,8,-3,200,False,False,200
LA1_1636447244,100,18540,16992,1548,100,False,10,8,2,100,True,True,100
LA1_1641973242,200,15679,17759,2080,200,False,4,7,3,200,False,True,200
LA1_1636853290,200,15435,15767,332,200,False,2,4,2,200,False,True,200
LA1_1636200810,200,17603,17835,232,200,False,7,7,0,0,False,False,100
LA1_1636440287,100,17228,15845,1383,100,False,6,4,2,100,True,True,100
LA1_1636370966,200,17781,17775,-6,100,False,8,9,1,200,False,True,200
LA1_1637275344,200,16289,14576,-1713,100,False,5,3,-2,100,True,False,100
LA1_1637125810,100,16447,17242,-795,200,False,7,7,0,0,False,False,200
LA1_1636278730,100,15294,18071,-2777,200,False,1,7,-6,200,False,False,200
LA1_1637127663,200,16742,18999,2257,200,False,5,12,7,200,False,True,200
LA1_1636866025,200,15139,16712,1573,200,False,2,5,3,200,False,False,100
LA1_1636784239,200,15903,17584,1681,200,False,3,7,4,200,False,True,200
LA1_1641974524,100,17241,17705,-464,200,False,6,7,-1,200,False,False,200
LA1_1634430290,200,18564,15154,-3410,100,False,9,2,-7,100,True,False,100
LA1_1635889765,100,15906,16011,-105,200,False,4,7,-3,200,False,False,200
LA1_1636132503,200,17367,18115,748,200,False,8,9,1,200,False,True,200
LA1_1639163157,100,16992,16502,490,100,False,7,6,1,100,True,True,100
LA1_1636161795,200,20077,17978,-2099,100,False,13,7,-6,100,True,False,100
LA1_1636111026,100,20331,16599,3732,100,False,16,6,10,100,True,True,100
LA1_1636513885,100,18160,15332,2828,100,False,10,3,7,100,True,True,100
LA1_1636772887,200,18185,15214,-2971,100,False,9,3,-6,100,True,False,100
LA1_1636147206,100,14829,16271,-1442,200,False,1,4,-3,200,False,False,200
LA1_1638228701,100,16495,15165,1330,100,False,6,3,3,100,True,False,200
LA1_1635933432,200,16356,16571,215,200,False,5,5,0,0,False,True,200
LA1_1638207962,200,16472,16432,-40,100,False,6,4,-2,100,True,True,200
LA1_1638105521,100,17696,17199,497,100,False,7,7,0,0,False,False,200
LA1_1636525479,200,18475,14995,-3480,100,False,9,4,-5,100,True,False,100
LA1_1636746148,100,15642,16340,-698,200,False,4,5,-1,200,False,False,200
LA1_1631599730,100,17009,18707,-1698,200,False,5,8,-3,200,False,True,100
LA1_1634211081,200,14924,17967,3043,200,False,1,6,5,200,False,True,200
LA1_1632437801,200,16651,19163,2512,200,False,5,9,4,200,False,True,200
LA1_1633209652,100,16326,17969,-1643,200,False,6,9,-3,200,False,False,200
LA1_1629849166,200,17291,16741,-550,100,False,7,6,-1,100,True,True,200
LA1_1635225058,200,15699,17242,1543,200,False,3,8,5,200,False,False,100
LA1_1631401674,200,17485,16410,-1075,100,False,7,3,-4,100,True,False,100
LA1_1634711754,100,15583,15874,-291,200,False,2,3,-1,200,False,True,100
LA1_1630241981,100,16912,17963,-1051,200,False,5,7,-2,200,False,False,200
LA1_1629878699,100,16936,17476,-540,200,False,6,5,1,100,True,True,100
LA1_1636905891,200,17372,16227,-1145,100,False,9,5,-4,100,True,True,200
LA1_1631807909,100,16271,17094,-823,200,False,4,9,-5,200,False,True,100
LA1_1630938867,200,17141,16063,-1078,100,False,6,5,-1,100,True,True,200
LA1_1629853856,100,16517,18209,-1692,200,False,4,8,-4,200,False,False,200
LA1_1629618193,200,16860,16110,-750,100,False,5,4,-1,100,True,True,200
LA1_1639459159,200,18373,17140,-1233,100,False,9,6,-3,100,True,False,100
LA1_1638187448,100,15863,16312,-449,200,False,1,4,-3,200,False,False,200
LA1_1634589887,200,17063,18577,1514,200,False,5,8,3,200,False,True,200
LA1_1629871299,200,17873,17356,-517,100,False,8,6,-2,100,True,True,200
LA1_1631396604,100,17288,16449,839,100,False,7,4,3,100,True,True,100
LA1_1640133548,200,17254,17380,126,200,False,7,6,-1,100,True,True,200
LA1_1629886779,100,17791,15619,2172,100,False,6,3,3,100,True,True,100
LA1_1638288499,200,17592,17396,-196,100,False,7,7,0,0,False,True,200
LA1_1630866575,200,17770,14516,-3254,100,False,9,1,-8,100,True,True,200
LA1_1631766885,100,16098,16153,-55,200,False,3,5,-2,200,False,True,100
LA1_1636329152,100,18027,16897,1130,100,False,10,4,6,100,True,False,200
LA1_1630851942,200,17938,18483,545,200,False,9,9,0,0,False,True,200
LA1_1629862982,200,16809,16769,-40,100,False,7,7,0,0,False,False,100
LA1_1639217869,200,15208,16317,1109,200,False,2,4,2,200,False,False,100
LA1_1640121813,100,17948,18425,-477,200,False,9,10,-1,200,False,True,100
LA1_1638347667,200,19905,17563,-2342,100,False,15,9,-6,100,True,False,100
LA1_1630246054,100,18966,15319,3647,100,False,9,3,6,100,True,True,100
LA1_1630105711,100,16556,15819,737,100,False,6,5,1,100,True,True,100
LA1_1638044295,200,16191,16935,744,200,False,6,5,-1,100,True,True,200
LA1_1630011423,100,18095,17379,716,100,False,8,8,0,0,False,False,200
LA1_1639941839,100,16815,14641,2174,100,False,4,1,3,100,True,True,100
LA1_1635202319,200,16373,17037,664,200,False,4,6,2,200,False,True,200
LA1_1636677688,200,17939,17395,-544,100,False,7,8,1,200,False,False,100
LA1_1629896940,200,18441,16181,-2260,100,False,9,5,-4,100,True,True,200
LA1_1637134080,100,17512,16803,709,100,False,7,4,3,100,True,True,100
LA1_1635210518,100,18063,14511,3552,100,False,7,2,5,100,True,True,100
LA1_1632267319,200,16233,15689,-544,100,False,2,3,1,200,False,True,200
LA1_1636641039,100,15942,16905,-963,200,False,6,6,0,0,False,False,200
LA1_1632286306,200,17149,15632,-1517,100,False,8,5,-3,100,True,False,100
LA1_1630966708,200,14589,16522,1933,200,False,2,6,4,200,False,True,200
LA1_1635077176,200,17991,16587,-1404,100,False,7,5,-2,100,True,False,100
LA1_1633197492,200,15390,16337,947,200,False,2,3,1,200,False,False,100
LA1_1640769406,100,17301,18623,-1322,200,False,7,8,-1,200,False,False,200
LA1_1633800905,200,15904,15482,-422,100,False,3,3,0,0,False,False,100
LA1_1636902111,200,15451,17935,2484,200,False,3,8,5,200,False,False,100
LA1_1632276706,200,17613,15540,-2073,100,False,8,4,-4,100,True,True,200
LA1_1637134926,200,20162,16702,-3460,100,False,13,5,-8,100,True,False,100
LA1_1630119664,200,17396,16570,-826,100,False,7,4,-3,100,True,False,100
LA1_1638189603,200,17747,18132,385,200,False,8,10,2,200,False,True,200
LA1_1640621653,200,14002,17714,3712,200,False,0,8,8,200,False,True,200
LA1_1630644061,200,15188,18371,3183,200,False,2,9,7,200,False,True,200
LA1_1640617695,100,16779,15888,891,100,False,4,3,1,100,True,True,100
LA1_1640865254,200,14987,16445,1458,200,False,1,6,5,200,False,True,200
LA1_1640808727,100,19478,15570,3908,100,False,12,4,8,100,True,True,100
LA1_1638632463,200,14422,18266,3844,200,False,2,10,8,200,False,True,200
LA1_1640694628,200,16445,16280,-165,100,False,6,8,2,200,False,True,200
LA1_1640729584,200,19566,15196,-4370,100,False,13,4,-9,100,True,False,100
LA1_1640820857,100,16021,16494,-473,200,False,5,6,-1,200,False,False,200
LA1_1640596164,200,16587,17878,1291,200,False,5,8,3,200,False,False,100
LA1_1641816325,100,18691,15405,3286,100,False,10,2,8,100,True,True,100
LA1_1629555262,200,18350,14573,-3777,100,False,11,3,-8,100,True,False,100
LA1_1641846982,100,17555,16903,652,100,False,6,5,1,100,True,False,200
LA1_1637595274,100,16720,16776,-56,200,False,6,3,3,100,True,True,100
LA1_1640342756,200,15627,15113,-514,100,False,4,3,-1,100,True,False,100
LA1_1639898671,100,16978,16671,307,100,False,5,4,1,100,True,True,100
LA1_1629379290,100,17989,14565,3424,100,False,9,3,6,100,True,True,100
LA1_1641788103,100,14615,20174,-5559,200,False,3,13,-10,200,False,False,200
LA1_1637607823,200,16404,17530,1126,200,False,4,6,2,200,False,True,200
LA1_1638048539,100,22637,16424,6213,100,False,18,7,11,100,True,True,100
LA1_1642033427,100,17383,17346,37,100,False,8,6,2,100,True,False,200
LA1_1640705080,100,18194,15944,2250,100,False,8,3,5,100,True,True,100
LA1_1637975943,200,15283,17738,2455,200,False,3,9,6,200,False,False,100
LA1_1641645079,100,17199,16700,499,100,False,6,5,1,100,True,True,100
LA1_1639934683,100,17033,17581,-548,200,False,4,9,-5,200,False,False,200
LA1_1640852382,100,17351,15888,1463,100,False,6,4,2,100,True,False,200
LA1_1640881596,200,14447,16095,1648,200,False,3,3,0,0,False,True,200
LA1_1629388476,100,17196,16577,619,100,False,6,4,2,100,True,True,100
LA1_1638055565,200,17192,18591,1399,200,False,6,8,2,200,False,False,100
LA1_1638981126,100,17776,16096,1680,100,False,7,5,2,100,True,True,100
LA1_1638402235,100,19625,17531,2094,100,False,12,8,4,100,True,False,200
LA1_1638685661,200,17197,17774,577,200,False,7,9,2,200,False,True,200
LA1_1638677270,100,18043,16417,1626,100,False,8,4,4,100,True,True,100
LA1_1637645306,200,17471,19417,1946,200,False,6,10,4,200,False,True,200
LA1_1637650313,200,18217,19764,1547,200,False,10,12,2,200,False,True,200
LA1_1639056706,100,17873,15809,2064,100,False,6,3,3,100,True,True,100
LA1_1637177167,100,16810,19917,-3107,200,False,9,13,-4,200,False,False,200
LA1_1643795102,200,19201,16221,-2980,100,False,11,4,-7,100,True,False,100
LA1_1643833980,200,19027,15935,-3092,100,False,10,4,-6,100,True,False,100
LA1_1643107634,200,18482,18099,-383,100,False,11,8,-3,100,True,True,200
LA1_1642428504,200,15723,17625,1902,200,False,6,9,3,200,False,True,200
LA1_1643842511,200,17243,16486,-757,100,False,9,7,-2,100,True,False,100
LA1_1643600675,100,17636,18108,-472,200,False,8,6,2,100,True,False,200
LA1_1642204038,200,17635,16612,-1023,100,False,9,7,-2,100,True,False,100
LA1_1643095602,200,16451,16326,-125,100,False,4,4,0,0,False,True,200
LA1_1642208598,100,16460,16232,228,100,False,7,6,1,100,True,False,200
LA1_1642238382,100,17902,14230,3672,100,False,7,1,6,100,True,True,100
LA1_1642397247,100,17061,17329,-268,200,False,7,7,0,0,False,False,200
LA1_1641732229,100,19070,19316,-246,200,False,11,13,-2,200,False,False,200
LA1_1643802029,100,16718,16630,88,100,False,6,7,-1,200,False,True,100
LA1_1642454460,200,18564,17969,-595,100,False,10,11,1,200,False,True,200
LA1_1643754407,100,18684,18751,-67,200,False,9,10,-1,200,False,True,100
LA1_1642250931,200,16891,16116,-775,100,False,4,5,1,200,False,False,100
LA1_1643808146,200,19678,15009,-4669,100,False,12,2,-10,100,True,False,100
LA1_1641746005,100,16489,14522,1967,100,False,3,1,2,100,True,True,100
LA1_1641605109,100,17234,14413,2821,100,False,7,1,6,100,True,True,100
LA1_1642439322,100,16237,17473,-1236,200,False,5,6,-1,200,False,False,200
LA1_1643826101,200,21514,16418,-5096,100,False,16,7,-9,100,True,False,100
LA1_1641725963,200,16714,15434,-1280,100,False,5,1,-4,100,True,False,100
LA1_1642414125,100,15736,17670,-1934,200,False,5,7,-2,200,False,True,100
LA1_1642240755,200,16783,16031,-752,100,False,4,3,-1,100,True,False,100
LA1_1643874425,200,15965,16810,845,200,False,5,5,0,0,False,False,100
LA1_1643830105,100,16104,15827,277,100,False,6,4,2,100,True,True,100
LA1_1642448026,200,15122,18465,3343,200,False,2,7,5,200,False,True,200
LA1_1641741258,200,20161,13883,-6278,100,False,13,1,-12,100,True,False,100
LA1_1639531126,100,16624,16188,436,100,False,4,4,0,0,False,True,100
LA1_1643810664,100,15319,17834,-2515,200,False,3,9,-6,200,False,True,100
LA1_1643595286,200,18299,15198,-3101,100,False,8,4,-4,100,True,False,100
LA1_1642214662,200,16679,17337,658,200,False,5,7,2,200,False,False,100
LA1_1643820166,200,16220,21335,5115,200,False,3,16,13,200,False,True,200
LA1_1643325097,200,19418,16184,-3234,100,False,10,6,-4,100,True,False,100
LA1_1643766270,100,16769,18750,-1981,200,False,8,11,-3,200,False,False,200
LA1_1642380258,100,17218,17151,67,100,False,8,7,1,100,True,True,100
LA1_1643950154,100,18752,17250,1502,100,False,10,9,1,100,True,False,200
LA1_1639505583,100,16357,17579,-1222,200,False,5,6,-1,200,False,True,100
LA1_1643793079,100,17741,15212,2529,100,False,8,2,6,100,True,True,100
LA1_1640204964,100,16313,17670,-1357,200,False,4,7,-3,200,False,False,200
LA1_1641804037,100,16338,17883,-1545,200,False,4,8,-4,200,False,True,100
LA1_1642871444,200,18458,17678,-780,100,False,9,7,-2,100,True,False,100
LA1_1638299218,100,16352,16291,61,100,False,4,5,-1,200,False,True,100
LA1_1640704104,100,16872,18292,-1420,200,False,6,10,-4,200,False,True,100
LA1_1642388079,200,17463,15619,-1844,100,False,5,4,-1,100,True,False,100
LA1_1638396493,100,16354,16922,-568,200,False,6,5,1,100,True,False,200
LA1_1642853242,200,15892,18796,2904,200,False,5,10,5,200,False,True,200
LA1_1638967426,100,16913,18342,-1429,200,False,9,7,2,100,True,True,100
LA1_1641523672,200,14639,16999,2360,200,False,2,7,5,200,False,True,200
LA1_1638660325,100,16427,17047,-620,200,False,6,6,0,0,False,False,200
LA1_1642369801,200,17001,18166,1165,200,False,6,10,4,200,False,True,200
LA1_1641513449,200,16254,17333,1079,200,False,4,9,5,200,False,True,200
LA1_1638757806,100,17343,16693,650,100,False,5,5,0,0,False,False,200
LA1_1640689219,200,16123,15744,-379,100,False,6,3,-3,100,True,False,100
LA1_1640219956,200,17280,16043,-1237,100,False,6,5,-1,100,True,True,200
LA1_1640259584,200,17376,15920,-1456,100,False,7,3,-4,100,True,False,100
LA1_1641541842,100,18280,15048,3232,100,False,6,2,4,100,True,True,100
LA1_1638479881,100,19081,16968,2113,100,False,9,4,5,100,True,True,100
LA1_1638665873,100,18785,15789,2996,100,False,11,5,6,100,True,True,100
LA1_1639482060,200,17876,19228,1352,200,False,10,11,1,200,False,False,100
LA1_1642352668,100,16577,17130,-553,200,False,5,6,-1,200,False,False,200
LA1_1638981415,200,17281,16766,-515,100,False,6,5,-1,100,True,False,100
LA1_1640696816,200,17655,15973,-1682,100,False,5,3,-2,100,True,False,100
LA1_1643518755,200,15200,16455,1255,200,False,4,7,3,200,False,True,200
LA1_1643547484,100,18428,16815,1613,100,False,8,7,1,100,True,True,100
LA1_1643283883,100,16250,16638,-388,200,False,7,8,-1,200,False,True,100
LA1_1643805227,200,20350,17182,-3168,100,False,13,6,-7,100,True,False,100
LA1_1643795759,200,15711,17836,2125,200,False,4,8,4,200,False,False,100
LA1_1642467072,200,19193,17229,-1964,100,False,12,7,-5,100,True,False,100
LA1_1642416372,100,16464,14860,1604,100,False,4,2,2,100,True,True,100
LA1_1643494229,100,15974,15246,728,100,False,3,2,1,100,True,True,100
LA1_1642402710,200,18273,17228,-1045,100,False,10,6,-4,100,True,False,100
LA1_1642222347,200,17988,16198,-1790,100,False,9,6,-3,100,True,False,100
LA1_1643292298,200,17238,18153,915,200,False,6,8,2,200,False,True,200
LA1_1644035821,100,17629,17659,-30,200,False,6,7,-1,200,False,False,200
LA1_1643289339,100,16164,16104,60,100,False,7,6,1,100,True,False,200
LA1_1644045402,100,15982,18364,-2382,200,False,4,7,-3,200,False,False,200
LA1_1643792502,100,15569,15938,-369,200,False,3,2,1,100,True,False,200
LA1_1644039815,200,15662,17963,2301,200,False,4,8,4,200,False,True,200
LA1_1643512521,100,15794,15851,-57,200,False,3,3,0,0,False,False,200
LA1_1642217665,200,19507,16528,-2979,100,False,14,5,-9,100,True,False,100
LA1_1643808635,100,17051,17583,-532,200,False,6,8,-2,200,False,False,200
LA1_1643547756,100,15817,17335,-1518,200,False,3,7,-4,200,False,True,100
LA1_1642220163,200,16548,16698,150,200,False,6,5,-1,100,True,True,200
LA1_1643468910,200,17841,13500,-4341,100,False,9,2,-7,100,True,False,100
LA1_1643543737,100,16334,16648,-314,200,False,3,6,-3,200,False,True,100
LA1_1643295219,200,17608,14472,-3136,100,False,7,2,-5,100,True,False,100
LA1_1642469242,100,14517,17419,-2902,200,False,2,5,-3,200,False,False,200
LA1_1642444071,100,16105,16872,-767,200,False,7,7,0,0,False,False,200
LA1_1643291952,200,16921,16871,-50,100,False,5,6,1,200,False,True,200
LA1_1642460553,100,16735,18039,-1304,200,False,8,8,0,0,False,True,100
LA1_1642429642,200,18071,15475,-2596,100,False,8,4,-4,100,True,False,100
LA1_1643545521,200,16629,14729,-1900,100,False,4,1,-3,100,True,True,200
LA1_1643538506,100,17508,16720,788,100,False,8,5,3,100,True,True,100
LA1_1643281197,100,16695,17616,-921,200,False,6,9,-3,200,False,True,100
LA1_1643530137,100,18166,18201,-35,200,False,8,9,-1,200,False,True,100
LA1_1642996856,100,14221,18639,-4418,200,False,1,10,-9,200,False,False,200
LA1_1643480521,100,17029,17268,-239,200,False,6,8,-2,200,False,True,100
LA1_1643271572,100,17122,14714,2408,100,False,6,3,3,100,True,True,100
LA1_1642461873,200,16548,14250,-2298,100,False,3,1,-2,100,True,False,100
LA1_1643551205,200,15064,16495,1431,200,False,2,5,3,200,False,True,200
LA1_1643536088,200,15255,18189,2934,200,False,3,10,7,200,False,True,200
LA1_1642455871,200,17566,16801,-765,100,False,8,9,1,200,False,True,200
LA1_1642465833,200,17799,16379,-1420,100,False,9,6,-3,100,True,True,200
LA1_1643790011,100,19910,16847,3063,100,False,10,5,5,100,True,True,100
LA1_1643787164,100,16851,14467,2384,100,False,6,2,4,100,True,True,100
LA1_1640507587,200,17127,15664,-1463,100,False,6,4,-2,100,True,False,100
LA1_1635925953,100,17512,18807,-1295,200,False,9,9,0,0,False,False,200
LA1_1641457981,200,16506,17026,520,200,False,5,6,1,200,False,True,200
LA1_1637892197,200,17881,16914,-967,100,False,8,5,-3,100,True,False,100
LA1_1640625494,100,18146,16086,2060,100,False,8,6,2,100,True,True,100
LA1_1641037201,100,18383,15762,2621,100,False,10,6,4,100,True,True,100
LA1_1640244412,100,16579,16567,12,100,False,7,7,0,0,False,False,200
LA1_1640999805,200,17329,19534,2205,200,False,10,13,3,200,False,True,200
LA1_1638830152,200,18237,17258,-979,100,False,8,7,-1,100,True,True,200
LA1_1641463429,200,15896,16976,1080,200,False,5,6,1,200,False,True,200
LA1_1641232538,200,16714,19327,2613,200,False,5,12,7,200,False,True,200
LA1_1639360303,100,17512,15647,1865,100,False,5,3,2,100,True,True,100
LA1_1640626621,200,17032,15007,-2025,100,False,8,2,-6,100,True,False,100
LA1_1638354156,100,16051,19112,-3061,200,False,5,11,-6,200,False,False,200
LA1_1641216881,100,18902,18676,226,100,False,10,10,0,0,False,True,100
LA1_1638950887,200,17140,16139,-1001,100,False,7,5,-2,100,True,False,100
LA1_1640008894,200,16848,15102,-1746,100,False,5,1,-4,100,True,False,100
LA1_1640132291,100,16991,16431,560,100,False,7,6,1,100,True,False,200
LA1_1641457010,100,17879,16550,1329,100,False,7,3,4,100,True,True,100
LA1_1641025888,100,17438,17211,227,100,False,8,8,0,0,False,True,100
LA1_1639987301,200,18979,15888,-3091,100,False,10,5,-5,100,True,False,100
LA1_1639704273,100,18924,15147,3777,100,False,10,2,8,100,True,True,100
LA1_1639400959,100,17167,17702,-535,200,False,5,8,-3,200,False,True,100
LA1_1641049550,100,16070,16426,-356,200,False,4,6,-2,200,False,False,200
LA1_1641465235,200,17278,15876,-1402,100,False,7,5,-2,100,True,False,100
LA1_1638845050,200,16251,16656,405,200,False,6,6,0,0,False,False,100
LA1_1638356113,100,17643,16317,1326,100,False,6,4,2,100,True,True,100
LA1_1637901264,100,17394,16749,645,100,False,7,4,3,100,True,True,100
LA1_1640958833,100,16852,16460,392,100,False,5,4,1,100,True,False,200
LA1_1638958830,100,15998,17795,-1797,200,False,3,8,-5,200,False,False,200
LA1_1641907808,100,17573,14175,3398,100,False,8,1,7,100,True,True,100
LA1_1640620973,100,20169,14927,5242,100,False,14,4,10,100,True,True,100
LA1_1639339048,200,15571,18338,2767,200,False,3,8,5,200,False,True,200
LA1_1638357313,200,18340,16142,-2198,100,False,9,5,-4,100,True,False,100
LA1_1641228011,200,16811,14550,-2261,100,False,3,2,-1,100,True,False,100
LA1_1639429831,100,16805,17559,-754,200,False,8,7,1,100,True,True,100
LA1_1639348442,100,16388,15674,714,100,False,6,4,2,100,True,True,100
LA1_1638355581,200,17626,15473,-2153,100,False,7,3,-4,100,True,False,100
LA1_1639420438,100,17870,15772,2098,100,False,9,5,4,100,True,True,100
LA1_1639729429,200,16987,18327,1340,200,False,6,8,2,200,False,True,200
LA1_1641016685,100,18709,16760,1949,100,False,11,6,5,100,True,True,100
LA1_1640138321,200,16313,17014,701,200,False,5,8,3,200,False,False,100
LA1_1641917399,200,16811,18247,1436,200,False,6,9,3,200,False,True,200
LA1_1641006961,200,17842,18173,331,200,False,9,8,-1,100,True,True,200
LA1_1641248765,100,16654,16462,192,100,False,6,5,1,100,True,False,200
LA1_1641459935,200,17778,19026,1248,200,False,7,10,3,200,False,True,200
LA1_1642914475,100,16428,15732,696,100,False,4,4,0,0,False,False,200
LA1_1642902556,200,17097,16884,-213,100,False,7,6,-1,100,True,False,100
LA1_1642877403,200,17773,17075,-698,100,False,9,3,-6,100,True,True,200
LA1_1642206224,200,17346,15981,-1365,100,False,6,2,-4,100,True,True,200
LA1_1641404149,200,16963,14652,-2311,100,False,4,0,-4,100,True,False,100
LA1_1642069896,100,17563,16542,1021,100,False,7,5,2,100,True,True,100
LA1_1641554609,200,15583,16378,795,200,False,4,4,0,0,False,True,200
LA1_1640446357,100,17945,16863,1082,100,False,12,5,7,100,True,True,100
LA1_1639757119,200,17684,17453,-231,100,False,10,6,-4,100,True,True,200
LA1_1640425628,200,17114,15175,-1939,100,False,6,4,-2,100,True,False,100
LA1_1639566178,200,18626,14643,-3983,100,False,10,5,-5,100,True,False,100
LA1_1640224213,100,16585,18238,-1653,200,False,9,11,-2,200,False,True,100
LA1_1640434212,200,18362,17287,-1075,100,False,9,8,-1,100,True,False,100
LA1_1640417692,100,18203,16835,1368,100,False,9,5,4,100,True,True,100
LA1_1639607741,200,18416,19667,1251,200,False,7,12,5,200,False,True,200
LA1_1640679634,100,19309,16469,2840,100,False,10,7,3,100,True,True,100
LA1_1640095712,100,15160,16274,-1114,200,False,3,3,0,0,False,False,200
LA1_1639602342,100,17845,16069,1776,100,False,8,5,3,100,True,False,200
LA1_1640170953,200,18664,16950,-1714,100,False,9,7,-2,100,True,True,200
LA1_1640380030,100,17180,15906,1274,100,False,6,5,1,100,True,True,100
LA1_1639558975,200,16550,19729,3179,200,False,4,13,9,200,False,False,100
LA1_1640484904,100,19301,17067,2234,100,False,12,6,6,100,True,True,100
LA1_1640145027,100,16399,16773,-374,200,False,5,7,-2,200,False,True,100
LA1_1640153045,200,16212,16503,291,200,False,5,3,-2,100,True,True,200
LA1_1640647901,200,16819,17783,964,200,False,6,9,3,200,False,True,200
LA1_1640640371,200,16451,16162,-289,100,False,6,6,0,0,False,False,100
LA1_1639841607,200,14834,18647,3813,200,False,3,11,8,200,False,True,200
LA1_1640411535,200,16804,19348,2544,200,False,8,12,4,200,False,True,200
LA1_1640210273,100,17659,18484,-825,200,False,9,10,-1,200,False,True,100
LA1_1639998475,100,16303,17123,-820,200,False,3,5,-2,200,False,True,100
LA1_1640652983,100,18573,16261,2312,100,False,10,5,5,100,True,True,100
LA1_1639454837,100,16079,17288,-1209,200,False,4,7,-3,200,False,True,100
LA1_1640494646,200,16254,18449,2195,200,False,5,7,2,200,False,True,200
LA1_1640642638,100,16782,17120,-338,200,False,6,6,0,0,False,False,200
LA1_1639825049,200,17686,15590,-2096,100,False,8,4,-4,100,True,False,100
LA1_1640455622,100,17080,16113,967,100,False,8,4,4,100,True,False,200
LA1_1640511878,100,17431,18294,-863,200,False,7,10,-3,200,False,False,200
LA1_1640236855,200,15292,18113,2821,200,False,4,10,6,200,False,False,100
LA1_1640384963,200,16922,16521,-401,100,False,6,6,0,0,False,False,100
LA1_1639827247,100,17419,14119,3300,100,False,7,1,6,100,True,False,200
LA1_1640161634,200,16176,17652,1476,200,False,3,7,4,200,False,True,200
LA1_1639836359,200,16637,17815,1178,200,False,6,8,2,200,False,False,100
LA1_1640097766,100,17951,15232,2719,100,False,7,2,5,100,True,True,100
LA1_1639741045,200,17371,15953,-1418,100,False,7,4,-3,100,True,True,200
LA1_1640525664,200,19315,15836,-3479,100,False,9,2,-7,100,True,False,100
LA1_1643300313,100,19188,13697,5491,100,False,11,1,10,100,True,True,100
LA1_1643788337,200,15177,19731,4554,200,False,2,13,11,200,False,True,200
LA1_1643693561,100,16793,16040,753,100,False,6,4,2,100,True,True,100
LA1_1643303142,100,16511,16397,114,100,False,5,4,1,100,True,False,200
LA1_1643909878,200,17042,15325,-1717,100,False,7,2,-5,100,True,False,100
LA1_1643786371,200,15685,17303,1618,200,False,3,7,4,200,False,True,200
LA1_1644002361,100,16243,19278,-3035,200,False,7,12,-5,200,False,False,200
LA1_1643550516,200,16924,17002,78,200,False,8,6,-2,100,True,False,100
LA1_1643527848,200,15221,16275,1054,200,False,3,4,1,200,False,True,200
LA1_1641378985,200,15224,18779,3555,200,False,3,12,9,200,False,True,200
LA1_1642430470,100,15492,16111,-619,200,False,4,5,-1,200,False,True,100
LA1_1643064296,100,16533,16001,532,100,False,5,4,1,100,True,True,100
LA1_1641674744,100,18163,16012,2151,100,False,9,5,4,100,True,False,200
LA1_1642182700,200,18062,16371,-1691,100,False,8,7,-1,100,True,False,100
LA1_1642831341,200,17685,17397,-288,100,False,6,8,2,200,False,False,100
LA1_1642442782,100,16835,17452,-617,200,False,6,7,-1,200,False,True,100
LA1_1642201369,200,15572,16636,1064,200,False,5,6,1,200,False,False,100
LA1_1643075840,100,17336,17731,-395,200,False,7,8,-1,200,False,True,100
LA1_1643946385,100,17445,16777,668,100,False,9,6,3,100,True,True,100
LA1_1641077709,200,18467,17887,-580,100,False,10,8,-2,100,True,False,100
LA1_1643246810,200,14723,15540,817,200,False,1,2,1,200,False,True,200
LA1_1642986596,200,16452,16335,-117,100,False,4,5,1,200,False,True,200
LA1_1642972764,100,19793,16488,3305,100,False,13,6,7,100,True,True,100
LA1_1642995070,100,19371,15111,4260,100,False,13,5,8,100,True,False,200
LA1_1641224699,200,17699,16823,-876,100,False,7,6,-1,100,True,False,100
LA1_1641025592,200,14244,17397,3153,200,False,1,6,5,200,False,True,200
LA1_1641258218,100,17550,15701,1849,100,False,7,8,-1,200,False,True,100
LA1_1643055393,200,17122,14623,-2499,100,False,8,2,-6,100,True,False,100
LA1_1642420599,100,17744,18033,-289,200,False,8,11,-3,200,False,True,100
LA1_1643535281,200,17390,16847,-543,100,False,6,6,0,0,False,True,200
LA1_1643046741,100,15075,17008,-1933,200,False,4,5,-1,200,False,False,200
LA1_1642948992,200,16742,19703,2961,200,False,8,11,3,200,False,True,200
LA1_1641268474,200,16880,17642,762,200,False,8,10,2,200,False,True,200
LA1_1642843301,200,18126,14432,-3694,100,False,8,2,-6,100,True,False,100
LA1_1643137909,100,19076,15819,3257,100,False,9,6,3,100,True,True,100
LA1_1643519647,100,15131,15684,-553,200,False,3,3,0,0,False,False,200
LA1_1643231542,100,17099,15824,1275,100,False,7,3,4,100,True,True,100
LA1_1643260289,100,15540,16124,-584,200,False,1,3,-2,200,False,False,200
LA1_1642963086,100,15705,18576,-2871,200,False,3,10,-7,200,False,False,200
LA1_1642924983,200,18160,15181,-2979,100,False,8,2,-6,100,True,False,100
LA1_1642389204,100,18483,16203,2280,100,False,10,5,5,100,True,True,100
LA1_1641360573,100,16328,15990,338,100,False,4,5,-1,200,False,True,100
LA1_1643728296,100,18064,16091,1973,100,False,6,4,2,100,True,True,100
LA1_1643271274,200,15427,17345,1918,200,False,7,7,0,0,False,False,100
LA1_1643091216,100,19772,17486,2286,100,False,12,6,6,100,True,True,100
LA1_1642205837,100,14586,17628,-3042,200,False,2,5,-3,200,False,True,100
LA1_1643744363,100,16236,15795,441,100,False,5,4,1,100,True,True,100
LA1_1642945253,100,14845,16640,-1795,200,False,4,6,-2,200,False,False,200
LA1_1642735176,200,17479,16852,-627,100,False,8,6,-2,100,True,False,100
LA1_1637508858,100,18182,15357,2825,100,False,10,4,6,100,True,True,100
LA1_1640482874,200,17608,18596,988,200,False,7,9,2,200,False,True,200
LA1_1637339703,200,16074,16382,308,200,False,4,4,0,0,False,True,200
LA1_1640494924,200,17236,15803,-1433,100,False,5,4,-1,100,True,False,100
LA1_1640470931,100,16431,16535,-104,200,False,5,5,0,0,False,False,200
LA1_1643814568,200,15287,19139,3852,200,False,4,11,7,200,False,True,200
LA1_1637332235,200,16592,15571,-1021,100,False,6,4,-2,100,True,False,100
LA1_1635738568,200,17335,16151,-1184,100,False,7,5,-2,100,True,False,100
LA1_1641353516,200,18184,17324,-860,100,False,10,5,-5,100,True,False,100
LA1_1637205577,100,15469,17274,-1805,200,False,4,6,-2,200,False,True,100
LA1_1641202392,200,17161,17089,-72,100,False,6,6,0,0,False,False,100
LA1_1636777569,100,15591,19059,-3468,200,False,4,13,-9,200,False,False,200
LA1_1633690560,200,17589,16304,-1285,100,False,10,6,-4,100,True,False,100
LA1_1635732505,100,16605,15684,921,100,False,4,2,2,100,True,False,200
LA1_1639017205,200,17964,15672,-2292,100,False,7,2,-5,100,True,False,100
LA1_1635731170,100,17560,16544,1016,100,False,10,5,5,100,True,False,200
LA1_1634015546,100,18108,15458,2650,100,False,8,4,4,100,True,False,200
LA1_1634009715,200,16977,15663,-1314,100,False,6,4,-2,100,True,True,200
LA1_1636335771,200,17076,15727,-1349,100,False,5,4,-1,100,True,False,100
LA1_1634021592,100,19777,15004,4773,100,False,13,4,9,100,True,True,100
LA1_1638985841,100,15706,14697,1009,100,False,2,0,2,100,True,True,100
LA1_1635862169,200,17282,15302,-1980,100,False,5,3,-2,100,True,False,100
LA1_1639007470,100,15220,17547,-2327,200,False,3,6,-3,200,False,False,200
LA1_1641157568,100,19245,17087,2158,100,False,12,7,5,100,True,False,200
LA1_1634054056,100,18087,15061,3026,100,False,8,4,4,100,True,True,100
LA1_1641312392,200,17514,16714,-800,100,False,8,6,-2,100,True,True,200
LA1_1641283441,200,19624,16705,-2919,100,False,11,6,-5,100,True,False,100
LA1_1641211081,100,15616,18691,-3075,200,False,4,9,-5,200,False,True,100
LA1_1632631745,200,15540,16248,708,200,False,4,3,-1,100,True,False,100
LA1_1632493982,200,17434,17312,-122,100,False,8,6,-2,100,True,True,200
LA1_1635839799,200,14292,17219,2927,200,False,1,6,5,200,False,True,200
LA1_1641337303,200,17107,15984,-1123,100,False,7,4,-3,100,True,False,100
LA1_1636757890,100,15977,16843,-866,200,False,4,5,-1,200,False,False,200
LA1_1641148548,100,16493,17618,-1125,200,False,3,7,-4,200,False,False,200
LA1_1641367725,100,16453,15672,781,100,False,3,2,1,100,True,False,200
LA1_1633931362,100,17453,18385,-932,200,False,5,8,-3,200,False,False,200
LA1_1635409828,100,17424,17186,238,100,False,8,7,1,100,True,True,100
LA1_1641326260,100,17175,16726,449,100,False,8,4,4,100,True,True,100
LA1_1637266012,200,17584,14924,-2660,100,False,9,4,-5,100,True,False,100
LA1_1636749804,100,15657,14781,876,100,False,3,2,1,100,True,True,100
LA1_1632482595,200,14500,15780,1280,200,False,2,3,1,200,False,True,200
LA1_1635569311,200,17357,15710,-1647,100,False,6,4,-2,100,True,True,200
LA1_1635423399,200,17095,17188,93,200,False,6,7,1,200,False,False,100
LA1_1635827646,200,16699,16992,293,200,False,5,6,1,200,False,True,200
LA1_1634041601,200,17877,16496,-1381,100,False,8,3,-5,100,True,True,200
LA1_1641270858,100,15137,16707,-1570,200,False,2,6,-4,200,False,False,200
LA1_1641297750,100,16934,18718,-1784,200,False,6,9,-3,200,False,True,100
LA1_1640323712,200,17428,15703,-1725,100,False,7,5,-2,100,True,True,200
LA1_1630612986,200,17020,15195,-1825,100,False,7,3,-4,100,True,False,100
LA1_1631552421,200,18283,18319,36,200,False,7,9,2,200,False,True,200
LA1_1632520821,100,17082,13652,3430,100,False,5,1,4,100,True,True,100
LA1_1631965751,100,18690,17816,874,100,False,11,9,2,100,True,False,200
LA1_1638834594,100,16792,17282,-490,200,False,6,7,-1,200,False,False,200
LA1_1631979459,100,15158,18795,-3637,200,False,3,12,-9,200,False,False,200
LA1_1638256866,200,15888,17609,1721,200,False,6,8,2,200,False,True,200
LA1_1627953156,200,16503,16166,-337,100,False,3,4,1,200,False,False,100
LA1_1643493227,100,16659,15895,764,100,False,6,3,3,100,True,False,200
LA1_1643361589,200,16754,16354,-400,100,False,7,4,-3,100,True,False,100
LA1_1643992438,200,15466,17258,1792,200,False,2,5,3,200,False,True,200
LA1_1643184283,200,19003,16691,-2312,100,False,8,8,0,0,False,False,100
LA1_1643034305,100,16210,16098,112,100,False,5,4,1,100,True,False,200
LA1_1642876548,100,19331,16080,3251,100,False,13,5,8,100,True,True,100
LA1_1643981666,100,17395,15900,1495,100,False,6,4,2,100,True,True,100
LA1_1643721597,100,16156,17915,-1759,200,False,3,8,-5,200,False,False,200
LA1_1642847398,100,16560,15469,1091,100,False,5,2,3,100,True,True,100
LA1_1643968387,100,14795,17644,-2849,200,False,1,5,-4,200,False,True,100
LA1_1644090009,200,18481,15820,-2661,100,False,10,4,-6,100,True,True,200
LA1_1643682982,200,18262,15039,-3223,100,False,7,2,-5,100,True,False,100
LA1_1643621099,100,19856,15509,4347,100,False,15,5,10,100,True,True,100
LA1_1643353570,200,17653,17151,-502,100,False,8,7,-1,100,True,True,200
LA1_1643860816,100,17256,15748,1508,100,False,9,5,4,100,True,True,100
LA1_1644097527,100,17487,19375,-1888,200,False,9,12,-3,200,False,False,200
LA1_1643465935,200,19438,15623,-3815,100,False,12,4,-8,100,True,False,100
LA1_1643372809,200,18140,14273,-3867,100,False,9,1,-8,100,True,False,100
LA1_1643162530,200,18565,15101,-3464,100,False,12,3,-9,100,True,False,100
LA1_1643017425,200,17662,15814,-1848,100,False,9,5,-4,100,True,True,200
LA1_1643097594,200,17458,16536,-922,100,False,6,3,-3,100,True,True,200
LA1_1643345446,200,18366,16300,-2066,100,False,7,6,-1,100,True,False,100
LA1_1643040976,100,19803,15501,4302,100,False,13,3,10,100,True,True,100
LA1_1642918003,200,15376,19098,3722,200,False,3,11,8,200,False,True,200
LA1_1643749276,100,17062,15687,1375,100,False,7,4,3,100,True,True,100
LA1_1642752932,100,18653,16541,2112,100,False,11,8,3,100,True,True,100
LA1_1643445609,200,15506,18995,3489,200,False,4,14,10,200,False,True,200
LA1_1643411395,100,16500,15889,611,100,False,5,3,2,100,True,True,100
LA1_1643652947,200,19919,13687,-6232,100,False,12,2,-10,100,True,False,100
LA1_1643875643,100,17753,16980,773,100,False,7,5,2,100,True,True,100
LA1_1644145492,100,18151,15722,2429,100,False,8,3,5,100,True,False,200
LA1_1643026731,100,16646,20343,-3697,200,False,7,13,-6,200,False,False,200
LA1_1643738316,100,16755,15726,1029,100,False,5,4,1,100,True,True,100
LA1_1643615155,100,16552,18276,-1724,200,False,5,11,-6,200,False,False,200
LA1_1643197521,200,17175,16780,-395,100,False,8,5,-3,100,True,True,200
LA1_1643643843,200,18035,16085,-1950,100,False,7,5,-2,100,True,False,100
LA1_1642858314,100,15612,16960,-1348,200,False,3,6,-3,200,False,False,200
LA1_1643868521,100,18562,17882,680,100,False,11,8,3,100,True,True,100
LA1_1643853471,200,20698,15420,-5278,100,False,15,4,-11,100,True,False,100
LA1_1633364936,200,16790,16623,-167,100,False,9,6,-3,100,True,True,200
LA1_1631862613,200,16873,16587,-286,100,False,7,7,0,0,False,True,200
LA1_1631642643,100,16077,19095,-3018,200,False,5,11,-6,200,False,False,200
LA1_1630287726,200,16064,16324,260,200,False,4,3,-1,100,True,True,200
LA1_1630039962,200,18122,15555,-2567,100,False,8,4,-4,100,True,False,100
LA1_1631901304,200,16568,17777,1209,200,False,6,7,1,200,False,False,100
LA1_1633934417,200,15271,17241,1970,200,False,3,7,4,200,False,False,100
LA1_1630051676,200,14826,17317,2491,200,False,2,6,4,200,False,True,200
LA1_1632671765,100,19443,14770,4673,100,False,13,2,11,100,True,True,100
LA1_1636865926,100,15848,17567,-1719,200,False,3,7,-4,200,False,False,200
LA1_1632868459,200,17703,18902,1199,200,False,9,9,0,0,False,True,200
LA1_1640874390,100,15775,16532,-757,200,False,4,5,-1,200,False,True,100
LA1_1637263917,200,15816,14699,-1117,100,False,3,4,1,200,False,True,200
LA1_1632877546,200,17688,16797,-891,100,False,7,5,-2,100,True,False,100
LA1_1633496300,100,14184,17510,-3326,200,False,3,7,-4,200,False,False,200
LA1_1636859358,100,16211,16762,-551,200,False,5,6,-1,200,False,True,100
LA1_1634771951,100,17210,17604,-394,200,False,6,6,0,0,False,False,200
LA1_1639779307,100,15396,17456,-2060,200,False,3,7,-4,200,False,False,200
LA1_1633507606,100,15338,15024,314,100,False,2,1,1,100,True,False,200
LA1_1640856905,100,20423,16174,4249,100,False,12,5,7,100,True,True,100
LA1_1633517588,100,18933,17337,1596,100,False,8,8,0,0,False,True,100
LA1_1638904472,100,18049,16332,1717,100,False,6,4,2,100,True,False,200
LA1_1638324663,100,17106,15170,1936,100,False,7,6,1,100,True,True,100
LA1_1639757611,200,17406,15474,-1932,100,False,7,4,-3,100,True,False,100
LA1_1636170346,200,17424,17313,-111,100,False,7,8,1,200,False,True,200
LA1_1637245310,200,15842,18996,3154,200,False,4,8,4,200,False,True,200
LA1_1637256029,200,18734,16176,-2558,100,False,10,4,-6,100,True,True,200
LA1_1641122539,200,16810,16017,-793,100,False,5,4,-1,100,True,False,100
LA1_1637803068,200,16136,15147,-989,100,False,6,2,-4,100,True,False,100
LA1_1637793004,200,16574,15380,-1194,100,False,7,3,-4,100,True,True,200
LA1_1633412606,100,17156,15793,1363,100,False,6,2,4,100,True,False,200
LA1_1638299493,200,16861,15896,-965,100,False,5,3,-2,100,True,True,200
LA1_1638316015,200,17442,18088,646,200,False,8,9,1,200,False,True,200
LA1_1633532079,200,16867,18488,1621,200,False,5,10,5,200,False,False,100
LA1_1637581452,200,17347,17944,597,200,False,7,9,2,200,False,False,100
LA1_1639767040,100,17430,15630,1800,100,False,7,2,5,100,True,True,100
LA1_1638883497,200,15994,19450,3456,200,False,5,11,6,200,False,True,200
LA1_1634442521,100,16156,17735,-1579,200,False,4,9,-5,200,False,False,200
LA1_1640842882,100,14740,16128,-1388,200,False,2,3,-1,200,False,False,200
LA1_1638891606,200,15737,19329,3592,200,False,5,15,10,200,False,True,200
LA1_1634781742,200,16246,15061,-1185,100,False,3,5,2,200,False,False,100
LA1_1635147488,200,16762,16339,-423,100,False,7,5,-2,100,True,False,100
LA1_1636640814,100,16835,15695,1140,100,False,7,3,4,100,True,True,100
LA1_1636656019,100,17427,15697,1730,100,False,7,5,2,100,True,True,100
LA1_1635130330,200,15717,16596,879,200,False,3,3,0,0,False,True,200
LA1_1640865270,200,16044,18281,2237,200,False,4,8,4,200,False,True,200
LA1_1639990465,100,17596,17808,-212,200,False,9,9,0,0,False,False,200
LA1_1639623522,100,17559,17452,107,100,False,7,6,1,100,True,False,200
LA1_1640518445,100,17472,18577,-1105,200,False,7,9,-2,200,False,True,100
LA1_1643078472,100,15199,15855,-656,200,False,6,5,1,100,True,False,200
LA1_1640871342,200,16807,15584,-1223,100,False,6,4,-2,100,True,True,200
LA1_1640282100,200,18063,15441,-2622,100,False,6,2,-4,100,True,False,100
LA1_1639918514,200,18295,18031,-264,100,False,9,8,-1,100,True,False,100
LA1_1642367428,100,16712,18182,-1470,200,False,6,11,-5,200,False,False,200
LA1_1642088510,100,16818,16176,642,100,False,6,4,2,100,True,True,100
LA1_1642580967,200,17729,15510,-2219,100,False,7,3,-4,100,True,False,100
LA1_1642347659,100,17589,17749,-160,200,False,6,8,-2,200,False,True,100
LA1_1643157066,200,19934,17260,-2674,100,False,12,6,-6,100,True,False,100
LA1_1643095292,100,20399,16508,3891,100,False,16,8,8,100,True,True,100
LA1_1643140703,200,17219,16676,-543,100,False,8,5,-3,100,True,False,100
LA1_1644115752,100,16516,17583,-1067,200,False,6,9,-3,200,False,True,100
LA1_1642605642,100,17591,16006,1585,100,False,7,4,3,100,True,False,200
LA1_1642910176,100,17293,16445,848,100,False,9,5,4,100,True,False,200
LA1_1643083410,100,15932,16586,-654,200,False,5,7,-2,200,False,True,100
LA1_1642138976,200,16642,16623,-19,100,False,7,6,-1,100,True,False,100
LA1_1642864714,200,15720,17023,1303,200,False,5,7,2,200,False,False,100
LA1_1643055997,200,15543,19295,3752,200,False,5,14,9,200,False,True,200
LA1_1642897352,100,14254,19017,-4763,200,False,1,10,-9,200,False,False,200
LA1_1642922961,200,17363,18668,1305,200,False,7,12,5,200,False,True,200
LA1_1643219632,100,15825,17484,-1659,200,False,5,7,-2,200,False,True,100
LA1_1643411976,200,15698,17427,1729,200,False,5,6,1,200,False,True,200
LA1_1642335056,200,16293,17132,839,200,False,5,6,1,200,False,True,200
LA1_1643457784,100,18509,15813,2696,100,False,9,3,6,100,True,False,200
LA1_1642099537,100,19110,17117,1993,100,False,13,6,7,100,True,True,100
LA1_1642151121,200,16083,16242,159,200,False,4,4,0,0,False,True,200
LA1_1643103609,100,19245,18074,1171,100,False,11,11,0,0,False,False,200
LA1_1643328165,200,17826,16737,-1089,100,False,8,7,-1,100,True,True,200
LA1_1643333669,200,17391,16524,-867,100,False,8,6,-2,100,True,False,100
LA1_1642111334,200,17533,16129,-1404,100,False,7,3,-4,100,True,False,100
LA1_1643116260,200,14790,18800,4010,200,False,2,9,7,200,False,True,200
LA1_1642595177,200,15832,15714,-118,100,False,5,6,1,200,False,False,100
LA1_1643311952,200,19181,15787,-3394,100,False,10,4,-6,100,True,False,100
LA1_1643429059,100,16600,17005,-405,200,False,4,6,-2,200,False,True,100
LA1_1642124130,200,16851,15944,-907,100,False,6,5,-1,100,True,False,100
LA1_1643668557,200,16477,16210,-267,100,False,6,5,-1,100,True,True,200
LA1_1642938082,100,18589,16261,2328,100,False,11,6,5,100,True,True,100
LA1_1642572728,200,17910,17215,-695,100,False,7,5,-2,100,True,False,100
LA1_1643073407,100,18222,16860,1362,100,False,7,5,2,100,True,True,100
LA1_1643647091,200,18535,14830,-3705,100,False,11,4,-7,100,True,False,100
LA1_1643440898,200,18092,16548,-1544,100,False,9,5,-4,100,True,True,200
LA1_1643654515,100,16785,17541,-756,200,False,6,9,-3,200,False,False,200
LA1_1642320703,100,16925,16112,813,100,False,5,3,2,100,True,True,100
LA1_1643406195,100,17013,15733,1280,100,False,6,3,3,100,True,True,100
LA1_1635940706,100,16465,18820,-2355,200,False,5,9,-4,200,False,False,200
LA1_1641445802,100,17115,16620,495,100,False,5,6,-1,200,False,False,200
LA1_1636154056,100,17988,16733,1255,100,False,9,5,4,100,True,False,200
LA1_1637821177,200,18855,16991,-1864,100,False,10,7,-3,100,True,False,100
LA1_1635950503,100,16948,16967,-19,200,False,6,5,1,100,True,True,100
LA1_1637784051,200,16589,18790,2201,200,False,7,11,4,200,False,False,100
LA1_1641458638,200,15849,19769,3920,200,False,6,12,6,200,False,True,200
LA1_1635959942,100,16267,16184,83,100,False,3,3,0,0,False,False,200
LA1_1636828101,100,17251,15540,1711,100,False,5,2,3,100,True,False,200
LA1_1643044276,100,15962,16077,-115,200,False,2,2,0,0,False,False,200
LA1_1641184177,200,16118,18919,2801,200,False,5,12,7,200,False,False,100
LA1_1639804307,100,15829,15650,179,100,False,5,5,0,0,False,False,200
LA1_1641183517,200,16632,17618,986,200,False,5,8,3,200,False,True,200
LA1_1641453167,100,17878,16631,1247,100,False,8,3,5,100,True,True,100
LA1_1641198432,100,17654,16397,1257,100,False,6,4,2,100,True,False,200
LA1_1641558496,200,17914,14005,-3909,100,False,8,1,-7,100,True,False,100
LA1_1639413299,100,16882,16795,87,100,False,4,6,-2,200,False,True,100
LA1_1641469810,100,18472,16563,1909,100,False,8,5,3,100,True,True,100
LA1_1641482528,200,16283,17275,992,200,False,4,5,1,200,False,True,200
LA1_1640730242,200,16225,16630,405,200,False,5,5,0,0,False,False,100
LA1_1642979402,200,18451,17292,-1159,100,False,9,7,-2,100,True,False,100
LA1_1640710738,200,19083,17118,-1965,100,False,10,6,-4,100,True,True,200
LA1_1643052629,100,15622,18745,-3123,200,False,4,12,-8,200,False,False,200
LA1_1643294466,200,17596,17279,-317,100,False,7,7,0,0,False,True,200
LA1_1641206259,100,16879,17607,-728,200,False,6,9,-3,200,False,False,200
LA1_1639693458,100,17165,15097,2068,100,False,5,2,3,100,True,True,100
LA1_1643294858,200,16465,17928,1463,200,False,10,11,1,200,False,True,200
LA1_1641536647,100,19268,19364,-96,200,False,12,13,-1,200,False,True,100
LA1_1641462224,200,15397,16353,956,200,False,3,4,1,200,False,True,200
LA1_1641530057,200,17857,16158,-1699,100,False,8,7,-1,100,True,False,100
LA1_1642971855,200,18319,16621,-1698,100,False,9,6,-3,100,True,False,100
LA1_1640722090,200,19202,16183,-3019,100,False,12,6,-6,100,True,False,100
LA1_1639664170,100,18166,15727,2439,100,False,9,3,6,100,True,True,100
LA1_1639674888,100,16668,15815,853,100,False,4,6,-2,200,False,True,100
LA1_1641484744,100,17018,16386,632,100,False,5,4,1,100,True,True,100
LA1_1641476884,200,15733,16578,845,200,False,4,5,1,200,False,False,100
LA1_1641504981,100,16846,17117,-271,200,False,5,5,0,0,False,True,100
LA1_1641494668,200,18047,16119,-1928,100,False,9,5,-4,100,True,False,100
LA1_1641465651,200,18057,18064,7,200,False,7,7,0,0,False,False,100
LA1_1641475563,100,16995,15814,1181,100,False,5,3,2,100,True,True,100
LA1_1641500281,100,17553,18031,-478,200,False,10,9,1,100,True,False,200
LA1_1632939468,100,17087,19017,-1930,200,False,8,9,-1,200,False,False,200
LA1_1629904193,100,17845,18071,-226,200,False,7,9,-2,200,False,False,200
LA1_1632943493,200,17102,16533,-569,100,False,6,7,1,200,False,False,100
LA1_1628915904,200,15985,17655,1670,200,False,4,8,4,200,False,True,200
LA1_1635494161,100,15994,15988,6,100,False,3,3,0,0,False,True,100
LA1_1635094384,100,16708,18654,-1946,200,False,7,10,-3,200,False,False,200
LA1_1637864672,200,17179,16872,-307,100,False,6,5,-1,100,True,False,100
LA1_1631606702,200,18439,15868,-2571,100,False,10,3,-7,100,True,False,100
LA1_1635003766,100,20693,14571,6122,100,False,15,5,10,100,True,True,100
LA1_1629834044,200,19431,15759,-3672,100,False,12,5,-7,100,True,False,100
LA1_1635107774,100,19085,16880,2205,100,False,13,6,7,100,True,True,100
LA1_1633350834,200,16809,15446,-1363,100,False,5,2,-3,100,True,False,100
LA1_1632956568,200,15864,17221,1357,200,False,7,8,1,200,False,False,100
LA1_1632975408,200,15825,16974,1149,200,False,4,6,2,200,False,True,200
LA1_1631597730,100,17157,17596,-439,200,False,8,7,1,100,True,False,200
LA1_1635522907,200,14783,16730,1947,200,False,4,5,1,200,False,False,100
LA1_1639744423,200,16649,17753,1104,200,False,4,10,6,200,False,False,100
LA1_1640534143,200,19520,16108,-3412,100,False,14,4,-10,100,True,False,100
LA1_1638811341,200,16539,15139,-1400,100,False,3,1,-2,100,True,False,100
LA1_1640749217,100,16524,15694,830,100,False,6,3,3,100,True,True,100
LA1_1640738653,100,16160,17667,-1507,200,False,2,7,-5,200,False,False,200
LA1_1636614625,100,16624,17722,-1098,200,False,7,8,-1,200,False,True,100
LA1_1635148841,200,17498,14807,-2691,100,False,8,1,-7,100,True,False,100
LA1_1642174934,100,16004,17260,-1256,200,False,4,7,-3,200,False,True,100
LA1_1635186214,100,16194,16916,-722,200,False,6,7,-1,200,False,True,100
LA1_1640558993,100,16476,16169,307,100,False,5,4,1,100,True,True,100
LA1_1636742104,100,16646,16876,-230,200,False,6,8,-2,200,False,True,100
LA1_1640774776,100,17318,15116,2202,100,False,6,3,3,100,True,True,100
LA1_1640281921,100,15649,16659,-1010,200,False,4,6,-2,200,False,False,200
LA1_1636762261,100,17105,17551,-446,200,False,8,7,1,100,True,True,100
LA1_1642163858,200,15811,16415,604,200,False,5,4,-1,100,True,True,200
LA1_1639475249,100,19802,16525,3277,100,False,12,6,6,100,True,True,100
LA1_1635171809,200,15516,20736,5220,200,False,5,18,13,200,False,True,200
LA1_1638827497,100,16817,15154,1663,100,False,6,4,2,100,True,True,100
LA1_1642149812,100,19218,17914,1304,100,False,10,8,2,100,True,False,200
LA1_1640545736,100,16455,15972,483,100,False,7,4,3,100,True,True,100
LA1_1640685874,100,18477,14911,3566,100,False,7,5,2,100,True,True,100
LA1_1639488394,200,14649,17678,3029,200,False,3,7,4,200,False,True,200
LA1_1635806040,100,17107,15784,1323,100,False,7,6,1,100,True,False,200
LA1_1640677979,100,17436,16357,1079,100,False,6,5,1,100,True,False,200
LA1_1636091826,200,16919,15213,-1706,100,False,7,2,-5,100,True,True,200
LA1_1636403140,200,19379,16065,-3314,100,False,10,5,-5,100,True,True,200
LA1_1640848493,200,18674,17701,-973,100,False,11,10,-1,100,True,False,100
LA1_1635081623,100,15620,17360,-1740,200,False,4,7,-3,200,False,True,100
LA1_1635160793,200,17092,14766,-2326,100,False,7,2,-5,100,True,False,100
LA1_1635060684,200,14981,16781,1800,200,False,3,5,2,200,False,True,200
LA1_1640463450,200,17946,18600,654,200,False,8,10,2,200,False,True,200
LA1_1636705088,100,18695,15293,3402,100,False,8,4,4,100,True,True,100
LA1_1633572687,100,18129,15493,2636,100,False,8,3,5,100,True,True,100
LA1_1634309472,100,16185,19000,-2815,200,False,4,10,-6,200,False,False,200
LA1_1641490317,200,17934,18236,302,200,False,9,11,2,200,False,True,200
LA1_1635019235,100,16053,16849,-796,200,False,7,6,1,100,True,True,100
LA1_1636921050,100,16333,15105,1228,100,False,5,3,2,100,True,False,200
LA1_1634753980,200,16661,16637,-24,100,False,5,5,0,0,False,True,200
LA1_1634319090,100,16131,17286,-1155,200,False,4,8,-4,200,False,True,100
LA1_1636699551,100,16966,15655,1311,100,False,8,4,4,100,True,False,200
LA1_1640580091,100,17171,18882,-1711,200,False,7,13,-6,200,False,False,200
LA1_1634750735,100,14330,16765,-2435,200,False,2,9,-7,200,False,False,200
LA1_1640379225,100,16923,16201,722,100,False,8,5,3,100,True,False,200
LA1_1635281300,100,15980,16324,-344,200,False,3,5,-2,200,False,True,100
LA1_1640646108,200,16559,17239,680,200,False,8,7,-1,100,True,False,100
LA1_1636938709,200,14492,15889,1397,200,False,3,2,-1,100,True,True,200
LA1_1640561641,200,16330,18305,1975,200,False,5,10,5,200,False,False,100
LA1_1639574775,100,17414,18664,-1250,200,False,8,12,-4,200,False,True,100
LA1_1639861606,100,17012,17060,-48,200,False,7,8,-1,200,False,False,200
LA1_1642028396,200,15826,17518,1692,200,False,4,5,1,200,False,True,200
LA1_1639217817,200,16921,15768,-1153,100,False,4,2,-2,100,True,True,200
LA1_1639442570,100,16723,14749,1974,100,False,6,2,4,100,True,True,100
LA1_1639666402,200,18353,16220,-2133,100,False,12,5,-7,100,True,False,100
LA1_1639409055,200,14920,16078,1158,200,False,5,5,0,0,False,True,200
LA1_1639735887,200,14943,17632,2689,200,False,4,5,1,200,False,True,200
LA1_1640064337,100,15922,14492,1430,100,False,5,3,2,100,True,False,200
LA1_1639378838,100,17446,16545,901,100,False,5,5,0,0,False,True,100
LA1_1639498011,100,17077,18007,-930,200,False,7,8,-1,200,False,True,100
LA1_1641973080,200,18351,17666,-685,100,False,10,7,-3,100,True,True,200
LA1_1642211663,100,18230,16197,2033,100,False,10,5,5,100,True,True,100
LA1_1639420040,100,18323,16454,1869,100,False,11,5,6,100,True,True,100
LA1_1639869460,200,17545,15639,-1906,100,False,9,4,-5,100,True,False,100
LA1_1639396283,200,17430,17791,361,200,False,6,6,0,0,False,False,100
LA1_1639309764,100,19109,16530,2579,100,False,12,7,5,100,True,True,100
LA1_1639834847,200,18093,15807,-2286,100,False,8,3,-5,100,True,False,100
LA1_1639373281,100,18273,16716,1557,100,False,11,7,4,100,True,True,100
LA1_1639330271,200,14409,18647,4238,200,False,1,9,8,200,False,True,200
LA1_1640138837,100,16633,16632,1,100,False,4,5,-1,200,False,False,200
LA1_1639876750,100,17563,17449,114,100,False,5,6,-1,200,False,False,200
LA1_1639819683,200,17161,13973,-3188,100,False,5,3,-2,100,True,True,200
LA1_1639338697,100,17244,14886,2358,100,False,6,0,6,100,True,True,100
LA1_1642037633,100,17157,17786,-629,200,False,10,10,0,0,False,False,200
LA1_1639830854,200,18862,14995,-3867,100,False,11,4,-7,100,True,False,100
LA1_1639698636,100,15456,15951,-495,200,False,3,4,-1,200,False,True,100
LA1_1639715847,200,16678,17622,944,200,False,5,8,3,200,False,True,200
LA1_1639536916,100,16781,15333,1448,100,False,6,3,3,100,True,True,100
LA1_1639321608,100,19682,15261,4421,100,False,11,4,7,100,True,True,100
LA1_1639297755,200,18700,16004,-2696,100,False,14,5,-9,100,True,True,200
LA1_1639848503,200,14968,18051,3083,200,False,3,8,5,200,False,True,200
LA1_1639541274,100,17027,16150,877,100,False,7,4,3,100,True,True,100
LA1_1639457406,100,17216,16980,236,100,False,8,6,2,100,True,True,100
LA1_1639531818,100,17648,17201,447,100,False,8,8,0,0,False,False,200
LA1_1640135068,200,17126,16412,-714,100,False,7,4,-3,100,True,True,200
LA1_1639679858,200,17372,17923,551,200,False,7,9,2,200,False,False,100
LA1_1636841085,200,16016,20607,4591,200,False,6,12,6,200,False,True,200
LA1_1636430155,100,16486,18292,-1806,200,False,5,9,-4,200,False,True,100
LA1_1634941035,200,18978,18808,-170,100,False,11,9,-2,100,True,True,200
LA1_1635165361,200,17389,14714,-2675,100,False,10,2,-8,100,True,True,200
LA1_1634974983,100,16100,17418,-1318,200,False,6,8,-2,200,False,False,200
LA1_1629755098,100,17204,15053,2151,100,False,5,3,2,100,True,False,200
LA1_1636189795,100,16386,16464,-78,200,False,6,8,-2,200,False,True,100
LA1_1639772135,200,15430,16598,1168,200,False,2,5,3,200,False,True,200
LA1_1631518895,200,15143,18207,3064,200,False,4,9,5,200,False,True,200
LA1_1634926939,100,17300,16640,660,100,False,7,4,3,100,True,False,200
LA1_1630005787,200,18081,16260,-1821,100,False,6,4,-2,100,True,False,100
LA1_1638735123,200,15158,17263,2105,200,False,3,7,4,200,False,True,200
LA1_1636613157,200,17808,18314,506,200,False,9,9,0,0,False,False,100
LA1_1641353938,100,16559,15456,1103,100,False,5,2,3,100,True,True,100
LA1_1643394321,100,15690,15119,571,100,False,2,2,0,0,False,False,200
LA1_1643915228,100,16721,20379,-3658,200,False,8,13,-5,200,False,False,200
LA1_1638646305,100,19827,16847,2980,100,False,15,9,6,100,True,True,100
LA1_1643681146,200,19942,20282,340,200,False,14,15,1,200,False,True,200
LA1_1643403490,100,14995,17494,-2499,200,False,2,8,-6,200,False,False,200
LA1_1643191697,200,16943,17932,989,200,False,5,8,3,200,False,True,200
LA1_1636638472,200,16871,16779,-92,100,False,8,4,-4,100,True,False,100
LA1_1636625938,100,15716,19516,-3800,200,False,5,10,-5,200,False,False,200
LA1_1643421464,200,19841,16422,-3419,100,False,11,8,-3,100,True,False,100
LA1_1643231150,100,16809,17976,-1167,200,False,6,8,-2,200,False,True,100
LA1_1638621556,200,16726,17589,863,200,False,5,8,3,200,False,False,100
LA1_1641585258,200,16586,14240,-2346,100,False,7,1,-6,100,True,False,100
LA1_1638629795,100,16620,16025,595,100,False,2,2,0,0,False,True,100
LA1_1638645062,200,16719,16325,-394,100,False,5,7,2,200,False,False,100
LA1_1643206918,200,15757,15316,-441,100,False,3,4,1,200,False,False,100
LA1_1643889079,200,17705,17495,-210,100,False,9,8,-1,100,True,False,100
LA1_1643855996,200,18593,18423,-170,100,False,10,8,-2,100,True,False,100
LA1_1640448773,200,16934,18881,1947,200,False,4,12,8,200,False,False,100
LA1_1643100699,200,18552,16177,-2375,100,False,7,4,-3,100,True,False,100
LA1_1643448903,100,17511,16142,1369,100,False,8,4,4,100,True,True,100
LA1_1643938272,100,15358,17758,-2400,200,False,3,5,-2,200,False,False,200
LA1_1643926148,100,16724,18454,-1730,200,False,6,12,-6,200,False,False,200
LA1_1643697472,200,17965,15951,-2014,100,False,11,6,-5,100,True,True,200
LA1_1643256074,100,16829,17049,-220,200,False,5,6,-1,200,False,True,100
LA1_1639066090,200,15199,17353,2154,200,False,3,6,3,200,False,True,200
LA1_1643949739,100,16017,16198,-181,200,False,2,5,-3,200,False,True,100
LA1_1643477291,100,17109,16517,592,100,False,4,4,0,0,False,True,100
LA1_1643899227,100,16154,16851,-697,200,False,3,7,-4,200,False,True,100
LA1_1643868894,200,15996,17138,1142,200,False,5,7,2,200,False,True,200
LA1_1635710346,100,17837,14390,3447,100,False,7,1,6,100,True,True,100
LA1_1643117425,200,19090,16428,-2662,100,False,11,5,-6,100,True,False,100
LA1_1643411612,100,14420,18951,-4531,200,False,3,12,-9,200,False,False,200
LA1_1640552893,200,17010,16770,-240,100,False,6,6,0,0,False,True,200
LA1_1637239716,200,16488,16882,394,200,False,5,6,1,200,False,True,200
LA1_1641651709,200,17571,17534,-37,100,False,7,6,-1,100,True,True,200
LA1_1637755228,200,19004,16758,-2246,100,False,12,8,-4,100,True,False,100
LA1_1640801651,100,17687,17439,248,100,False,7,7,0,0,False,False,200
LA1_1640522769,200,16244,19036,2792,200,False,5,10,5,200,False,False,100
LA1_1641066658,100,16153,16911,-758,200,False,3,6,-3,200,False,True,100
LA1_1638005747,100,17051,15172,1879,100,False,8,4,4,100,True,True,100
LA1_1640094132,200,18538,16042,-2496,100,False,9,4,-5,100,True,False,100
LA1_1637483387,100,16751,17379,-628,200,False,4,6,-2,200,False,True,100
LA1_1639369392,200,15379,17284,1905,200,False,3,6,3,200,False,True,200
LA1_1640470593,200,17514,17366,-148,100,False,8,9,1,200,False,True,200
LA1_1640899661,200,16392,17010,618,200,False,5,6,1,200,False,True,200
LA1_1637020822,100,18706,16788,1918,100,False,10,7,3,100,True,True,100
LA1_1641328680,200,16376,16465,89,200,False,6,5,-1,100,True,True,200
LA1_1640914810,100,17252,14814,2438,100,False,6,1,5,100,True,True,100
LA1_1641727528,200,18409,17306,-1103,100,False,10,8,-2,100,True,True,200
LA1_1640898261,100,15150,15394,-244,200,False,4,4,0,0,False,True,100
LA1_1639824762,200,17611,14695,-2916,100,False,8,2,-6,100,True,False,100
LA1_1640896490,100,21587,15203,6384,100,False,18,6,12,100,True,True,100
LA1_1636789744,200,17253,17565,312,200,False,8,10,2,200,False,False,100
LA1_1641725431,200,16250,16263,13,200,False,5,5,0,0,False,True,200
LA1_1636592636,200,18394,16783,-1611,100,False,6,6,0,0,False,False,100
LA1_1641603441,200,15212,17866,2654,200,False,3,7,4,200,False,True,200
LA1_1639819967,200,18294,16146,-2148,100,False,8,5,-3,100,True,False,100
LA1_1640210126,200,19185,18246,-939,100,False,11,8,-3,100,True,False,100
LA1_1637060663,100,16850,18035,-1185,200,False,8,9,-1,200,False,False,200
LA1_1640203233,200,16248,16714,466,200,False,3,8,5,200,False,False,100
LA1_1637036799,200,15821,18055,2234,200,False,5,9,4,200,False,True,200
LA1_1637929533,100,16768,16023,745,100,False,5,4,1,100,True,True,100
LA1_1637047739,200,19191,15381,-3810,100,False,13,2,-11,100,True,False,100
LA1_1640223985,200,16528,16773,245,200,False,8,9,1,200,False,False,100
LA1_1636664836,200,17824,16972,-852,100,False,7,5,-2,100,True,False,100
LA1_1636580395,200,19955,15579,-4376,100,False,15,4,-11,100,True,False,100
LA1_1638220161,100,16594,16288,306,100,False,4,4,0,0,False,True,100
LA1_1638207128,100,18798,15757,3041,100,False,10,2,8,100,True,True,100
LA1_1638192209,100,16920,17225,-305,200,False,7,7,0,0,False,True,100
LA1_1640910624,100,15777,17719,-1942,200,False,3,7,-4,200,False,False,200
LA1_1636806040,100,17820,17518,302,100,False,12,12,0,0,False,True,100
LA1_1637009772,200,15009,17805,2796,200,False,2,6,4,200,False,False,100
LA1_1640919954,100,16381,15385,996,100,False,7,5,2,100,True,False,200
LA1_1639821016,100,15910,15970,-60,200,False,3,3,0,0,False,False,200
LA1_1636999461,100,19384,16662,2722,100,False,11,5,6,100,True,True,100
LA1_1638236064,200,18231,18096,-135,100,False,10,9,-1,100,True,False,100
LA1_1640930115,100,16627,15382,1245,100,False,4,3,1,100,True,True,100
LA1_1640902572,200,16710,16340,-370,100,False,5,6,1,200,False,True,200
LA1_1636781377,100,16429,15523,906,100,False,6,6,0,0,False,False,200
LA1_1639814870,100,16041,17112,-1071,200,False,3,5,-2,200,False,False,200
LA1_1637959409,200,18159,18219,60,200,False,8,10,2,200,False,True,200
LA1_1641342975,100,19724,17309,2415,100,False,9,7,2,100,True,True,100
LA1_1637242146,200,15902,15327,-575,100,False,6,5,-1,100,True,False,100
LA1_1643122710,200,18555,16857,-1698,100,False,10,7,-3,100,True,True,200
LA1_1643377762,200,18853,16230,-2623,100,False,10,5,-5,100,True,False,100
LA1_1643045343,100,19473,17647,1826,100,False,12,7,5,100,True,True,100
LA1_1643249641,100,15146,19561,-4415,200,False,3,12,-9,200,False,False,200
LA1_1642812314,200,18509,17386,-1123,100,False,12,9,-3,100,True,True,200
LA1_1643494874,100,15625,16638,-1013,200,False,4,5,-1,200,False,False,200
LA1_1642804162,100,16112,15869,243,100,False,5,5,0,0,False,True,100
LA1_1642820640,100,16966,16055,911,100,False,6,5,1,100,True,True,100
LA1_1643583786,100,17097,15364,1733,100,False,5,2,3,100,True,True,100
LA1_1643112067,100,15900,19188,-3288,200,False,5,13,-8,200,False,False,200
LA1_1643623139,100,18033,18620,-587,200,False,8,9,-1,200,False,True,100
LA1_1642866594,200,16500,15448,-1052,100,False,5,4,-1,100,True,True,200
LA1_1643614186,200,15881,16223,342,200,False,4,5,1,200,False,True,200
LA1_1643822310,100,15628,14902,726,100,False,4,1,3,100,True,True,100
LA1_1642798210,100,18618,17245,1373,100,False,9,8,1,100,True,False,200
LA1_1643235448,100,16623,16321,302,100,False,4,4,0,0,False,True,100
LA1_1642695201,200,16429,16934,505,200,False,4,5,1,200,False,True,200
LA1_1643061836,200,18455,18190,-265,100,False,10,8,-2,100,True,False,100
LA1_1643866965,100,15472,17685,-2213,200,False,3,9,-6,200,False,False,200
LA1_1642532290,100,16321,14874,1447,100,False,6,3,3,100,True,False,200
LA1_1643339005,100,16959,17160,-201,200,False,7,6,1,100,True,True,100
LA1_1642836705,100,17206,15843,1363,100,False,7,7,0,0,False,False,200
LA1_1643840355,100,15200,15205,-5,200,False,1,4,-3,200,False,True,100
LA1_1643513428,200,16872,15909,-963,100,False,4,2,-2,100,True,True,200
LA1_1640418693,200,15429,19766,4337,200,False,3,11,8,200,False,False,100
LA1_1642473404,200,17639,17082,-557,100,False,9,7,-2,100,True,False,100
LA1_1640910280,100,16297,18777,-2480,200,False,3,11,-8,200,False,False,200
LA1_1642229776,100,16751,17985,-1234,200,False,7,10,-3,200,False,False,200
LA1_1640920739,100,17956,16697,1259,100,False,7,5,2,100,True,False,200
LA1_1640926841,100,14707,17681,-2974,200,False,2,8,-6,200,False,True,100
LA1_1641999959,100,17239,16589,650,100,False,7,5,2,100,True,True,100
LA1_1640782226,200,15981,17397,1416,200,False,5,5,0,0,False,True,200
LA1_1640375647,100,16435,16081,354,100,False,4,5,-1,200,False,True,100
LA1_1642355221,100,13987,16095,-2108,200,False,1,7,-6,200,False,True,100
LA1_1641481262,100,16645,16110,535,100,False,5,5,0,0,False,False,200
LA1_1641981676,200,17351,15241,-2110,100,False,6,2,-4,100,True,False,100
LA1_1642366318,200,17078,16193,-885,100,False,8,3,-5,100,True,False,100
LA1_1640677162,200,14277,16719,2442,200,False,2,4,2,200,False,True,200
LA1_1641492806,100,19710,18595,1115,100,False,11,11,0,0,False,True,100
LA1_1640454741,200,17826,17488,-338,100,False,8,6,-2,100,True,True,200
LA1_1640936366,200,16111,15540,-571,100,False,4,2,-2,100,True,True,200
LA1_1642610914,200,18497,18150,-347,100,False,11,9,-2,100,True,True,200
LA1_1641403311,100,18471,15817,2654,100,False,8,5,3,100,True,True,100
LA1_1640914426,200,15191,16151,960,200,False,4,4,0,0,False,False,100
LA1_1642012426,100,16597,19670,-3073,200,False,7,12,-5,200,False,False,200
LA1_1642237005,100,18203,17988,215,100,False,9,10,-1,200,False,False,200
LA1_1642479788,100,14982,15684,-702,200,False,1,3,-2,200,False,False,200
LA1_1642949278,100,20677,15869,4808,100,False,15,6,9,100,True,True,100
LA1_1641982132,200,16121,17822,1701,200,False,4,8,4,200,False,False,100
LA1_1641508334,100,14587,18232,-3645,200,False,4,13,-9,200,False,False,200
LA1_1641442916,200,13578,18220,4642,200,False,1,5,4,200,False,True,200
LA1_1641557280,100,15998,18263,-2265,200,False,4,9,-5,200,False,False,200
LA1_1640370348,100,17996,18061,-65,200,False,7,10,-3,200,False,False,200
LA1_1641978883,100,16124,19311,-3187,200,False,4,10,-6,200,False,False,200
LA1_1641564831,200,17471,18423,952,200,False,8,9,1,200,False,True,200
LA1_1642008250,100,16980,16382,598,100,False,4,3,1,100,True,True,100
LA1_1640763926,100,14862,15311,-449,200,False,2,4,-2,200,False,False,200
LA1_1640249994,100,18417,17259,1158,100,False,8,10,-2,200,False,True,100
LA1_1642934254,200,18418,17097,-1321,100,False,10,7,-3,100,True,False,100
LA1_1641577799,200,18214,16609,-1605,100,False,11,7,-4,100,True,False,100
LA1_1641070226,200,16590,16686,96,200,False,7,7,0,0,False,True,200
LA1_1642486205,100,16406,15273,1133,100,False,3,1,2,100,True,True,100
LA1_1630433614,200,16847,19724,2877,200,False,6,10,4,200,False,True,200
LA1_1635505103,200,14559,17741,3182,200,False,2,6,4,200,False,True,200
LA1_1636727766,100,16590,18143,-1553,200,False,8,9,-1,200,False,False,200
LA1_1635428477,100,17048,16028,1020,100,False,6,5,1,100,True,True,100
LA1_1632677581,200,16906,18207,1301,200,False,7,8,1,200,False,False,100
LA1_1629456213,200,17059,14273,-2786,100,False,6,2,-4,100,True,True,200
LA1_1629127361,100,17019,15823,1196,100,False,5,7,-2,200,False,True,100
LA1_1632793453,100,16225,16356,-131,200,False,5,5,0,0,False,False,200
LA1_1636757406,100,14229,18501,-4272,200,False,1,11,-10,200,False,False,200
LA1_1635413364,200,16972,18041,1069,200,False,6,12,6,200,False,False,100
LA1_1628663985,100,15874,18520,-2646,200,False,6,13,-7,200,False,False,200
LA1_1633959351,200,17549,17379,-170,100,False,7,6,-1,100,True,True,200
LA1_1629077739,200,16058,17991,1933,200,False,4,10,6,200,False,True,200
LA1_1634165248,200,17447,16556,-891,100,False,5,5,0,0,False,True,200
LA1_1635445979,100,17002,17668,-666,200,False,8,8,0,0,False,False,200
LA1_1628671901,200,16783,16795,12,200,False,4,7,3,200,False,False,100
LA1_1632686749,100,19246,17276,1970,100,False,12,6,6,100,True,False,200
LA1_1629972725,100,17274,16517,757,100,False,6,6,0,0,False,False,200
LA1_1637812128,200,15672,17539,1867,200,False,4,7,3,200,False,False,100
LA1_1634193166,200,16251,16825,574,200,False,4,7,3,200,False,True,200
LA1_1630418393,100,16001,15575,426,100,False,4,3,1,100,True,True,100
LA1_1637176163,200,16526,15358,-1168,100,False,7,4,-3,100,True,False,100
LA1_1636631405,200,17901,15015,-2886,100,False,9,4,-5,100,True,False,100
LA1_1630405177,100,17653,17096,557,100,False,10,7,3,100,True,False,200
LA1_1638172239,200,16933,15262,-1671,100,False,5,4,-1,100,True,False,100
LA1_1635498482,200,15640,15646,6,200,False,4,4,0,0,False,True,200
LA1_1630001983,100,15638,16227,-589,200,False,3,4,-1,200,False,True,100
LA1_1629986516,100,17373,17079,294,100,False,7,6,1,100,True,True,100
LA1_1636650940,100,17597,16001,1596,100,False,8,4,4,100,True,True,100
LA1_1634229459,100,15937,17053,-1116,200,False,5,8,-3,200,False,True,100
LA1_1632804285,100,19401,18260,1141,100,False,12,9,3,100,True,False,200
LA1_1628076358,200,16288,16675,387,200,False,4,6,2,200,False,True,200
LA1_1634181092,100,16518,16557,-39,200,False,6,6,0,0,False,False,200
LA1_1632694385,200,15686,14557,-1129,100,False,3,2,-1,100,True,True,200
LA1_1636738871,200,18929,17938,-991,100,False,11,7,-4,100,True,True,200
LA1_1634219935,200,20071,18111,-1960,100,False,13,8,-5,100,True,True,200
LA1_1638162240,200,17148,15928,-1220,100,False,6,3,-3,100,True,False,100
LA1_1639587518,100,15547,17224,-1677,200,False,5,6,-1,200,False,False,200
LA1_1642084055,100,17612,16820,792,100,False,8,4,4,100,True,True,100
LA1_1639903659,200,16934,15897,-1037,100,False,7,4,-3,100,True,True,200
LA1_1643256188,100,15452,14691,761,100,False,2,1,1,100,True,True,100
LA1_1642747569,200,15195,16426,1231,200,False,2,5,3,200,False,True,200
LA1_1641928207,100,15738,17619,-1881,200,False,3,7,-4,200,False,False,200
LA1_1641913949,200,15345,15201,-144,100,False,3,2,-1,100,True,False,100
LA1_1640359343,200,16272,17713,1441,200,False,5,8,3,200,False,True,200
LA1_1641861687,100,19840,18466,1374,100,False,13,9,4,100,True,True,100
LA1_1640821428,200,16593,18080,1487,200,False,4,7,3,200,False,True,200
LA1_1640837089,200,16729,16613,-116,100,False,7,8,1,200,False,False,100
LA1_1641876733,100,15816,17469,-1653,200,False,2,7,-5,200,False,False,200
LA1_1641439885,100,16151,18013,-1862,200,False,3,8,-5,200,False,True,100
LA1_1640332826,200,15302,15648,346,200,False,3,4,1,200,False,True,200
LA1_1640341278,200,16487,14835,-1652,100,False,5,2,-3,100,True,True,200
LA1_1640878574,200,19995,15929,-4066,100,False,14,6,-8,100,True,True,200
LA1_1640354802,100,17928,18252,-324,200,False,9,10,-1,200,False,False,200
LA1_1640348727,100,18577,17308,1269,100,False,10,5,5,100,True,True,100
LA1_1638520709,100,16946,17537,-591,200,False,7,6,1,100,True,False,200
LA1_1641118977,200,16472,16483,11,200,False,3,4,1,200,False,True,200
LA1_1638594306,200,17367,15500,-1867,100,False,6,2,-4,100,True,True,200
LA1_1638579034,200,17390,16581,-809,100,False,7,6,-1,100,True,False,100
LA1_1640324489,100,16224,15709,515,100,False,4,3,1,100,True,False,200
LA1_1641992181,200,16330,15763,-567,100,False,6,5,-1,100,True,False,100
LA1_1638642897,100,14586,16051,-1465,200,False,3,4,-1,200,False,False,200
LA1_1638265711,200,16785,16617,-168,100,False,6,8,2,200,False,False,100
LA1_1641132688,100,15024,15648,-624,200,False,2,4,-2,200,False,False,200
LA1_1642001340,200,16984,16261,-723,100,False,6,4,-2,100,True,False,100
LA1_1641105324,100,16622,15415,1207,100,False,6,3,3,100,True,True,100
LA1_1640306220,100,15975,15659,316,100,False,1,4,-3,200,False,False,200
LA1_1638641749,200,16430,16673,243,200,False,6,6,0,0,False,False,100
LA1_1638637162,100,17307,15566,1741,100,False,6,3,3,100,True,True,100
LA1_1638638938,200,15457,17748,2291,200,False,5,9,4,200,False,True,200
LA1_1640884552,100,17780,15959,1821,100,False,10,5,5,100,True,True,100
LA1_1640349757,200,15347,16847,1500,200,False,4,5,1,200,False,True,200
LA1_1638630364,100,15929,15321,608,100,False,4,5,-1,200,False,True,100
LA1_1640864252,100,14339,18279,-3940,200,False,3,9,-6,200,False,False,200
LA1_1640869800,200,18000,18959,959,200,False,10,11,1,200,False,True,200
LA1_1640353316,100,15972,15287,685,100,False,7,4,3,100,True,False,200
LA1_1640802206,200,17076,15910,-1166,100,False,7,2,-5,100,True,True,200
LA1_1641451217,200,18536,17831,-705,100,False,11,8,-3,100,True,False,100
LA1_1640349377,200,16074,16778,704,200,False,6,4,-2,100,True,True,200
LA1_1638557095,200,15773,17238,1465,200,False,4,6,2,200,False,False,100
LA1_1641144230,100,16443,16469,-26,200,False,6,5,1,100,True,True,100
LA1_1640849640,100,19775,18053,1722,100,False,15,10,5,100,True,False,200
LA1_1640357051,100,16796,17584,-788,200,False,5,8,-3,200,False,True,100
LA1_1637848193,200,17652,16231,-1421,100,False,7,5,-2,100,True,True,200
LA1_1638121091,100,17415,18460,-1045,200,False,8,11,-3,200,False,False,200
LA1_1636610188,100,16400,17749,-1349,200,False,6,8,-2,200,False,False,200
LA1_1636311423,100,17434,17172,262,100,False,7,6,1,100,True,True,100
LA1_1636437913,100,17712,18335,-623,200,False,7,11,-4,200,False,False,200
LA1_1637841225,100,16845,15742,1103,100,False,6,4,2,100,True,True,100
LA1_1636370207,100,15364,15587,-223,200,False,4,4,0,0,False,True,100
LA1_1637601349,100,18112,16337,1775,100,False,8,6,2,100,True,False,200
