match_id,my_team,team1_gold,team2_gold,gold_diff,gold_leading_team,my_team_ahead_gold,team1_kills,team2_kills,kill_diff,kill_leading_team,my_team_ahead_kills,my_team_win,winner
LA1_1644052629,200,16893,17558,665,200,False,8,10,2,200,False,False,100
LA1_1643600470,100,18290,15922,2368,100,False,8,5,3,100,True,True,100
LA1_1643579534,200,15810,16031,221,200,False,1,4,3,200,False,True,200
LA1_1643589079,100,16319,17328,1009,200,False,5,8,3,200,True,False,200
LA1_1644049119,200,16807,18248,1441,200,False,6,8,2,200,False,True,200
LA1_1644043312,100,15419,15725,306,200,False,3,4,1,200,True,True,100
LA1_1643595372,200,14377,17396,3019,200,False,2,4,2,200,False,True,200
LA1_1643651686,200,17588,16727,861,100,False,10,8,2,100,False,False,100
LA1_1643620399,200,17184,16683,501,100,False,8,7,1,100,False,True,200
LA1_1643611961,200,16568,16878,310,200,False,5,6,1,200,False,True,200
LA1_1643606399,100,16981,17092,111,200,False,5,6,1,200,True,True,100
LA1_1635471758,200,15340,16773,1433,200,False,2,5,3,200,False,True,200
LA1_1635476104,100,15045,15728,683,200,False,1,3,2,200,True,True,100
LA1_1636536380,200,18497,15812,2685,100,False,9,4,5,100,False,False,100
LA1_1635302678,200,15458,16224,766,200,False,4,6,2,200,False,True,200
LA1_1636544473,100,16888,17665,777,200,False,5,10,5,200,True,False,200
LA1_1635494109,100,16146,17789,1643,200,False,5,7,2,200,True,False,200
LA1_1635485292,100,16102,16983,881,200,False,6,6,0,0,False,False,200
LA1_1636549452,200,15079,16495,1416,200,False,2,3,1,200,False,True,200
LA1_1635479993,100,17341,17694,353,200,False,7,8,1,200,True,False,200
LA1_1637194627,200,14957,15546,589,200,False,3,3,0,0,False,False,100
LA1_1643676282,200,17166,17410,244,200,False,8,7,1,100,False,True,200
LA1_1643920633,100,17535,17124,411,100,False,5,6,1,200,True,False,200
LA1_1643700508,200,17448,19003,1555,200,False,10,11,1,200,False,False,100
LA1_1643659714,100,17904,17586,318,100,False,9,8,1,100,True,False,200
LA1_1643956181,100,16569,16088,481,100,False,5,6,1,200,True,True,100
LA1_1643905824,200,16211,18217,2006,200,False,7,10,3,200,False,True,200
LA1_1643732620,100,17066,17107,41,200,False,8,7,1,100,True,True,100
LA1_1643714147,200,17103,16511,592,100,False,8,6,2,100,False,True,200
LA1_1643671002,100,18542,16104,2438,100,False,7,4,3,100,True,True,100
LA1_1631099944,200,17225,15534,1691,100,False,7,2,5,100,False,False,100
LA1_1628755220,200,16242,18991,2749,200,False,4,10,6,200,False,True,200
LA1_1629230156,100,16151,17791,1640,200,False,5,9,4,200,True,True,100
LA1_1628780920,100,16626,15580,1046,100,False,7,2,5,100,True,True,100
LA1_1628771172,200,17348,15525,1823,100,False,7,4,3,100,False,False,100
LA1_1639187407,100,15806,14238,1568,100,False,4,3,1,100,True,False,200
LA1_1639292599,100,15068,16122,1054,200,False,4,6,2,200,True,True,100
LA1_1628555998,100,16545,15465,1080,100,False,3,1,2,100,True,True,100
LA1_1628547797,200,18680,16102,2578,100,False,9,5,4,100,False,True,200
LA1_1631089929,200,20618,16622,3996,100,False,15,7,8,100,False,False,100
LA1_1639314642,200,17100,16191,909,100,False,7,4,3,100,False,True,200
LA1_1635545162,100,15064,17972,2908,200,False,4,9,5,200,True,False,200
LA1_1635060566,100,17258,15486,1772,100,False,8,5,3,100,True,True,100
LA1_1638388695,100,16508,16519,11,200,False,6,6,0,0,False,True,100
LA1_1643890499,200,19248,15657,3591,100,False,12,5,7,100,False,True,200
LA1_1641851119,200,15748,16682,934,200,False,5,7,2,200,False,True,200
LA1_1641061042,100,19162,20698,1536,200,False,14,17,3,200,True,False,200
LA1_1643879293,100,18492,19626,1134,200,False,11,14,3,200,True,True,100
LA1_1641049879,200,15799,16809,1010,200,False,4,5,1,200,False,False,100
LA1_1642044489,200,17594,16459,1135,100,False,8,7,1,100,False,False,100
LA1_1641030557,100,16481,17920,1439,200,False,6,10,4,200,True,False,200
LA1_1643870648,200,17803,15109,2694,100,False,6,3,3,100,False,False,100
LA1_1641036984,200,16595,16624,29,200,False,5,6,1,200,False,True,200
LA1_1642051772,200,15895,15343,552,100,False,4,4,0,0,False,True,200
LA1_1641837183,100,15985,16061,76,200,False,5,5,0,0,False,True,100
LA1_1639439449,100,15654,17442,1788,200,False,4,10,6,200,True,False,200
LA1_1640135106,100,18414,18582,168,200,False,10,10,0,0,False,False,200
LA1_1639421423,200,16776,17153,377,200,False,7,5,2,100,False,False,100
LA1_1639601849,100,14490,19454,4964,200,False,3,11,8,200,True,False,200
LA1_1639401003,200,18597,14906,3691,100,False,10,3,7,100,False,True,200
LA1_1639611152,100,14328,18917,4589,200,False,2,8,6,200,True,False,200
LA1_1640138935,200,16384,17735,1351,200,False,7,9,2,200,False,False,100
LA1_1639559172,200,15454,15744,290,200,False,2,5,3,200,False,True,200
LA1_1639380493,200,19662,17396,2266,100,False,14,9,5,100,False,True,200
LA1_1639673450,200,19325,18227,1098,100,False,14,10,4,100,False,False,100
LA1_1637289971,200,17495,15342,2153,100,False,7,4,3,100,False,False,100
LA1_1642082981,200,14142,17679,3537,200,False,2,7,5,200,False,True,200
LA1_1637643874,200,20821,17532,3289,100,False,13,7,6,100,False,False,100
LA1_1638094260,100,17943,16186,1757,100,False,9,5,4,100,True,True,100
LA1_1636541446,100,15506,16418,912,200,False,5,7,2,200,True,False,200
LA1_1637634610,100,18455,17166,1289,100,False,10,8,2,100,True,True,100
LA1_1642065347,100,17635,15582,2053,100,False,6,4,2,100,True,False,200
LA1_1638114627,100,14921,19291,4370,200,False,4,12,8,200,True,False,200
LA1_1636927094,100,17174,17124,50,100,False,6,5,1,100,True,True,100
LA1_1637914217,100,14782,14710,72,100,False,2,0,2,100,True,False,200
LA1_1639287689,200,16765,16615,150,100,False,7,5,2,100,False,True,200
LA1_1637866684,200,17521,18490,969,200,False,8,13,5,200,False,True,200
LA1_1637851601,100,18342,14722,3620,100,False,8,1,7,100,True,True,100
LA1_1637857871,200,17835,14996,2839,100,False,9,3,6,100,False,False,100
LA1_1637131448,200,16601,14915,1686,100,False,4,2,2,100,False,False,100
LA1_1639299236,100,16700,18322,1622,200,False,7,8,1,200,True,False,200
LA1_1637856492,100,15014,18387,3373,200,False,3,9,6,200,True,False,200
LA1_1636898436,200,17538,17232,306,100,False,8,6,2,100,False,False,100
LA1_1637131235,100,19319,16138,3181,100,False,13,7,6,100,True,True,100
LA1_1639308774,200,16304,17138,834,200,False,4,9,5,200,False,False,100
LA1_1641627624,100,18150,17611,539,100,False,9,8,1,100,True,False,200
LA1_1641497802,100,16830,18129,1299,200,False,8,10,2,200,True,False,200
LA1_1642547875,100,15433,18235,2802,200,False,4,8,4,200,True,False,200
LA1_1642902556,100,17097,16884,213,100,False,7,6,1,100,True,True,100
LA1_1641023883,200,18346,20485,2139,200,False,10,15,5,200,False,False,100
LA1_1642932087,200,17283,16218,1065,100,False,6,4,2,100,False,True,200
LA1_1628294341,200,15173,17450,2277,200,False,2,6,4,200,False,False,100
LA1_1643640419,200,17818,15945,1873,100,False,7,3,4,100,False,False,100
LA1_1642914475,200,16428,15732,696,100,False,4,4,0,0,False,True,200
LA1_1641038549,200,17132,17254,122,200,False,7,7,0,0,False,False,100
LA1_1643658533,100,15709,16333,624,200,False,4,4,0,0,False,True,100
LA1_1643650253,200,17211,18295,1084,200,False,6,10,4,200,False,True,200
LA1_1642889759,200,19100,16651,2449,100,False,11,7,4,100,False,False,100
LA1_1639147668,200,15392,18337,2945,200,False,1,7,6,200,False,True,200
LA1_1639314350,100,21855,17444,4411,100,False,18,9,9,100,True,True,100
LA1_1638786180,100,17652,15182,2470,100,False,6,2,4,100,True,True,100
LA1_1638775173,100,16231,14481,1750,100,False,5,3,2,100,True,False,200
LA1_1639162961,100,18677,17415,1262,100,False,12,8,4,100,True,True,100
LA1_1638177818,200,16311,16449,138,200,False,5,7,2,200,False,False,100
LA1_1639305423,100,17463,18198,735,200,False,8,9,1,200,True,False,200
LA1_1638805418,200,16159,18216,2057,200,False,5,8,3,200,False,True,200
LA1_1639178004,200,16988,16498,490,100,False,5,5,0,0,False,False,100
LA1_1639323026,100,18065,16786,1279,100,False,9,7,2,100,True,True,100
LA1_1638793536,200,15298,17189,1891,200,False,3,9,6,200,False,True,200
LA1_1639491708,100,15484,17740,2256,200,False,1,7,6,200,True,True,100
LA1_1637051373,200,17721,16248,1473,100,False,8,4,4,100,False,True,200
LA1_1637764315,100,15763,18615,2852,200,False,5,10,5,200,True,False,200
LA1_1638031205,100,15742,17859,2117,200,False,4,8,4,200,True,True,100
LA1_1637309670,100,15902,17207,1305,200,False,6,5,1,100,True,False,200
LA1_1640047520,100,15844,18969,3125,200,False,3,12,9,200,True,False,200
LA1_1639744423,100,16649,17753,1104,200,False,4,10,6,200,True,True,100
LA1_1638564471,100,18316,17537,779,100,False,10,9,1,100,True,False,200
LA1_1638829629,100,18713,15984,2729,100,False,9,4,5,100,True,True,100
LA1_1637000056,200,16523,19271,2748,200,False,5,11,6,200,False,True,200
LA1_1637037339,200,17433,18540,1107,200,False,8,11,3,200,False,False,100
LA1_1637332736,100,19522,15155,4367,100,False,11,3,8,100,True,True,100
LA1_1637014812,200,18046,19075,1029,200,False,8,13,5,200,False,False,100
LA1_1636886110,100,15984,17950,1966,200,False,3,7,4,200,True,False,200
LA1_1636721702,200,14867,15959,1092,200,False,4,2,2,100,False,True,200
LA1_1637006722,200,19399,15876,3523,100,False,14,5,9,100,False,False,100
LA1_1637027103,200,18167,16928,1239,100,False,9,5,4,100,False,False,100
LA1_1636784239,100,15903,17584,1681,200,False,3,7,4,200,True,False,200
LA1_1636793135,100,16679,17760,1081,200,False,6,7,1,200,True,False,200
LA1_1637324587,200,16950,17557,607,200,False,7,8,1,200,False,False,100
LA1_1640876319,100,16623,15629,994,100,False,5,4,1,100,True,False,200
LA1_1643395825,200,15807,18645,2838,200,False,5,11,6,200,False,True,200
LA1_1636014344,100,17232,16290,942,100,False,9,5,4,100,True,False,200
LA1_1636006217,200,17052,17811,759,200,False,8,12,4,200,False,False,100
LA1_1635956971,200,16543,16172,371,100,False,5,4,1,100,False,False,100
LA1_1639314999,200,15673,16142,469,200,False,4,5,1,200,False,True,200
LA1_1635182646,200,16976,16776,200,100,False,10,8,2,100,False,True,200
LA1_1636011449,100,17076,14715,2361,100,False,8,2,6,100,True,True,100
LA1_1639309843,100,20775,15368,5407,100,False,13,5,8,100,True,True,100
LA1_1640928606,200,18436,18020,416,100,False,12,7,5,100,False,False,100
LA1_1635998938,200,16932,17312,380,200,False,8,7,1,100,False,False,100
LA1_1633058771,200,18603,16156,2447,100,False,9,5,4,100,False,False,100
LA1_1633044830,200,14574,16816,2242,200,False,1,6,5,200,False,True,200
LA1_1633185550,200,19508,17486,2022,100,False,12,10,2,100,False,False,100
LA1_1632000179,200,14639,17015,2376,200,False,1,6,5,200,False,True,200
LA1_1632343562,100,17084,18094,1010,200,False,6,8,2,200,True,False,200
LA1_1632358094,200,18520,17086,1434,100,False,13,8,5,100,False,False,100
LA1_1633189863,200,17638,16809,829,100,False,8,5,3,100,False,False,100
LA1_1632003363,200,17025,14963,2062,100,False,8,4,4,100,False,False,100
LA1_1632618849,100,19096,16380,2716,100,False,10,5,5,100,True,True,100
LA1_1642070236,100,15506,17434,1928,200,False,4,7,3,200,True,False,200
LA1_1640091030,100,17767,16094,1673,100,False,5,10,5,200,True,True,100
LA1_1643613487,200,19233,16457,2776,100,False,12,6,6,100,False,False,100
LA1_1643884462,100,17452,15768,1684,100,False,7,5,2,100,True,True,100
LA1_1643626542,200,14173,16861,2688,200,False,1,6,5,200,False,True,200
LA1_1643408880,200,14200,18492,4292,200,False,3,11,8,200,False,True,200
LA1_1643605377,100,15251,16968,1717,200,False,3,6,3,200,True,False,200
LA1_1643864948,100,18909,16825,2084,100,False,12,9,3,100,True,True,100
LA1_1643851992,100,15627,17288,1661,200,False,4,10,6,200,True,False,200
LA1_1643877373,100,16619,16141,478,100,False,4,4,0,0,False,False,200
LA1_1643900304,200,15059,16729,1670,200,False,1,5,4,200,False,True,200
LA1_1643619631,200,18467,14506,3961,100,False,9,2,7,100,False,False,100
LA1_1643398728,100,16712,15995,717,100,False,7,6,1,100,True,False,200
LA1_1635280010,200,16755,18071,1316,200,False,8,9,1,200,False,True,200
LA1_1629988202,200,15846,16423,577,200,False,5,5,0,0,False,True,200
LA1_1631846169,100,17031,16580,451,100,False,6,6,0,0,False,True,100
LA1_1629992713,200,16731,16379,352,100,False,5,4,1,100,False,False,100
LA1_1633055843,100,15142,16422,1280,200,False,2,5,3,200,True,False,200
LA1_1639116378,200,16756,16400,356,100,False,7,4,3,100,False,False,100
LA1_1631839604,200,17431,15362,2069,100,False,7,2,5,100,False,False,100
LA1_1631862434,200,15481,16589,1108,200,False,3,5,2,200,False,True,200
LA1_1629966347,200,16954,15515,1439,100,False,5,4,1,100,False,False,100
LA1_1631852646,100,16168,16302,134,200,False,4,3,1,100,True,True,100
LA1_1629977610,200,17134,14813,2321,100,False,7,3,4,100,False,False,100
LA1_1640136619,200,13814,17738,3924,200,False,1,6,5,200,False,True,200
LA1_1640650542,100,16696,17828,1132,200,False,7,10,3,200,True,False,200
LA1_1640121687,100,16127,16849,722,200,False,7,8,1,200,True,False,200
LA1_1634893615,100,15857,17407,1550,200,False,3,7,4,200,True,False,200
LA1_1634832331,200,16294,15781,513,100,False,5,6,1,200,False,False,100
LA1_1634847163,100,17735,14685,3050,100,False,8,1,7,100,True,True,100
LA1_1634970565,200,18095,15306,2789,100,False,9,6,3,100,False,True,200
LA1_1634958383,200,19079,15548,3531,100,False,11,5,6,100,False,True,200
LA1_1634928338,100,15143,17909,2766,200,False,4,8,4,200,True,True,100
LA1_1634962964,100,15245,16957,1712,200,False,3,4,1,200,True,True,100
LA1_1643434278,100,15423,15332,91,100,False,4,2,2,100,True,False,200
LA1_1634911935,100,16198,16314,116,200,False,5,4,1,100,True,True,100
LA1_1639122665,100,16281,20564,4283,200,False,6,14,8,200,True,False,200
LA1_1639114489,100,16868,15885,983,100,False,8,3,5,100,True,True,100
LA1_1634948658,100,16550,14713,1837,100,False,6,2,4,100,True,True,100
LA1_1634172188,100,16459,19675,3216,200,False,8,14,6,200,True,False,200
LA1_1634727414,100,17892,15533,2359,100,False,9,4,5,100,True,True,100
LA1_1637385641,100,15041,16630,1589,200,False,2,5,3,200,True,False,200
LA1_1634888930,100,14972,16691,1719,200,False,2,5,3,200,True,False,200
LA1_1634873171,100,17641,16990,651,100,False,8,6,2,100,True,True,100
LA1_1634728175,100,18134,20167,2033,200,False,9,13,4,200,True,False,200
LA1_1634563050,200,16127,16223,96,200,False,4,4,0,0,False,True,200
LA1_1637394131,200,16707,17319,612,200,False,10,6,4,100,False,False,100
LA1_1634187235,200,15751,17932,2181,200,False,5,9,4,200,False,True,200
LA1_1634908180,200,15139,17100,1961,200,False,4,6,2,200,False,True,200
LA1_1634333916,200,16914,17101,187,200,False,8,8,0,0,False,False,100
LA1_1633947363,100,16289,16124,165,100,False,6,7,1,200,True,True,100
LA1_1643854066,100,15226,16697,1471,200,False,3,5,2,200,True,False,200
LA1_1634327895,100,16000,15229,771,100,False,3,4,1,200,True,True,100
LA1_1643840968,200,17299,18012,713,200,False,8,9,1,200,False,True,200
LA1_1634689418,100,18537,15880,2657,100,False,9,4,5,100,True,True,100
LA1_1634683038,200,16649,15465,1184,100,False,7,6,1,100,False,False,100
LA1_1643858725,200,17137,15451,1686,100,False,7,4,3,100,False,True,200
LA1_1634342617,200,16196,16337,141,200,False,4,6,2,200,False,False,100
LA1_1643836641,100,16561,18231,1670,200,False,6,9,3,200,True,False,200
LA1_1633165031,200,15829,16605,776,200,False,3,5,2,200,False,True,200
LA1_1633137617,100,16680,17068,388,200,False,6,9,3,200,True,False,200
LA1_1633143198,200,15412,16731,1319,200,False,3,5,2,200,False,True,200
LA1_1633133105,200,16733,16269,464,100,False,5,4,1,100,False,False,100
LA1_1633133845,200,18740,15637,3103,100,False,9,4,5,100,False,False,100
LA1_1632916965,100,16221,16260,39,200,False,7,5,2,100,True,False,200
LA1_1633145802,200,17594,15099,2495,100,False,8,3,5,100,False,False,100
LA1_1633166572,200,16925,16250,675,100,False,4,3,1,100,False,False,100
LA1_1632917469,100,16940,18025,1085,200,False,6,8,2,200,True,False,200
LA1_1633155511,200,15704,16186,482,200,False,4,5,1,200,False,True,200
LA1_1633172737,200,18574,18204,370,100,False,11,11,0,0,False,False,100
LA1_1640543299,100,18383,16776,1607,100,False,9,6,3,100,True,False,200
LA1_1639863168,100,16318,17464,1146,200,False,5,5,0,0,False,True,100
LA1_1642025491,200,17682,17448,234,100,False,7,7,0,0,False,False,100
LA1_1643181442,100,15703,16482,779,200,False,3,4,1,200,True,False,200
LA1_1643345571,200,18013,15195,2818,100,False,9,3,6,100,False,False,100
LA1_1643212403,200,16612,14792,1820,100,False,7,3,4,100,False,False,100
LA1_1643193931,200,14183,17157,2974,200,False,2,6,4,200,False,True,200
LA1_1643161950,100,18558,14436,4122,100,False,9,2,7,100,True,True,100
LA1_1643224974,100,17186,15412,1774,100,False,6,3,3,100,True,True,100
LA1_1643556136,100,17808,16928,880,100,False,10,9,1,100,True,True,100
LA1_1643334993,200,17905,20454,2549,200,False,10,14,4,200,False,False,100
LA1_1643850571,200,15365,18182,2817,200,False,2,8,6,200,False,True,200
LA1_1643838619,200,18424,19897,1473,200,False,8,15,7,200,False,True,200
LA1_1643439575,100,16713,17008,295,200,False,5,5,0,0,False,False,200
LA1_1622038964,200,17818,16878,940,100,False,8,8,0,0,False,False,100
LA1_1631689751,200,16886,17577,691,200,False,7,8,1,200,False,True,200
LA1_1621339731,200,16986,16365,621,100,False,7,6,1,100,False,True,200
LA1_1621794967,200,15572,17590,2018,200,False,2,6,4,200,False,True,200
LA1_1628487551,100,17123,16657,466,100,False,7,6,1,100,True,False,200
LA1_1636012863,200,14791,16888,2097,200,False,1,5,4,200,False,True,200
LA1_1622056783,100,17503,16235,1268,100,False,6,5,1,100,True,True,100
LA1_1634260537,200,17487,16960,527,100,False,9,8,1,100,False,True,200
LA1_1621081508,100,18526,17559,967,100,False,10,8,2,100,True,True,100
LA1_1627265707,200,16324,18574,2250,200,False,6,9,3,200,False,True,200
LA1_1628500996,100,16386,17681,1295,200,False,5,6,1,200,True,True,100
LA1_1642648697,100,19759,15858,3901,100,False,9,3,6,100,True,True,100
LA1_1643478442,200,18411,17660,751,100,False,11,9,2,100,False,False,100
LA1_1643259429,200,17381,17884,503,200,False,8,7,1,100,False,False,100
LA1_1643233763,100,16999,16546,453,100,False,4,5,1,200,True,False,200
LA1_1643721600,100,16111,15176,935,100,False,4,4,0,0,False,True,100
LA1_1643463142,100,15770,17538,1768,200,False,4,7,3,200,True,False,200
LA1_1643246555,100,17714,15564,2150,100,False,7,3,4,100,True,True,100
LA1_1643492053,200,16868,16944,76,200,False,5,5,0,0,False,True,200
LA1_1643740086,200,18595,14984,3611,100,False,11,3,8,100,False,False,100
LA1_1643958679,100,14014,16815,2801,200,False,1,6,5,200,True,False,200
LA1_1642950316,200,15623,17048,1425,200,False,4,8,4,200,False,True,200
LA1_1643972624,200,17611,15742,1869,100,False,8,5,3,100,False,False,100
LA1_1643475196,100,15793,15545,248,100,False,3,3,0,0,False,True,100
LA1_1642936212,200,17083,16726,357,100,False,7,5,2,100,False,True,200
LA1_1643461272,100,15129,15111,18,100,False,3,4,1,200,True,False,200
LA1_1642962024,100,15908,20836,4928,200,False,6,15,9,200,True,True,100
LA1_1642843259,200,16656,15010,1646,100,False,4,2,2,100,False,False,100
LA1_1643990186,100,15721,18242,2521,200,False,7,10,3,200,True,False,200
LA1_1643489005,100,17733,16652,1081,100,False,9,6,3,100,True,False,200
LA1_1642826979,100,15363,17265,1902,200,False,4,6,2,200,True,True,100
LA1_1637664892,200,16260,17468,1208,200,False,6,8,2,200,False,False,100
LA1_1636995051,200,15886,17118,1232,200,False,2,9,7,200,False,False,100
LA1_1636583545,100,19074,15149,3925,100,False,10,3,7,100,True,True,100
LA1_1633899872,200,16802,17572,770,200,False,6,10,4,200,False,True,200
LA1_1632985879,100,16874,17254,380,200,False,7,7,0,0,False,False,200
LA1_1634985753,100,16030,16608,578,200,False,3,5,2,200,True,False,200
LA1_1633908805,100,15939,18728,2789,200,False,5,9,4,200,True,False,200
LA1_1633940824,200,15904,14953,951,100,False,5,1,4,100,False,True,200
LA1_1633003819,200,17199,14282,2917,100,False,6,1,5,100,False,False,100
LA1_1632995693,100,18569,17298,1271,100,False,10,6,4,100,True,True,100
LA1_1633932853,100,18268,14976,3292,100,False,7,2,5,100,True,True,100
LA1_1633919091,200,21067,16588,4479,100,False,16,7,9,100,False,False,100
LA1_1633922697,200,16677,15797,880,100,False,6,4,2,100,False,True,200
LA1_1635617903,100,17344,16290,1054,100,False,6,5,1,100,True,True,100
LA1_1637712322,200,16207,18437,2230,200,False,4,9,5,200,False,False,100
LA1_1640405092,100,17207,15877,1330,100,False,5,3,2,100,True,True,100
LA1_1637686096,100,16583,15322,1261,100,False,8,4,4,100,True,True,100
LA1_1641043683,100,17369,16484,885,100,False,9,5,4,100,True,True,100
LA1_1641029642,100,16130,17398,1268,200,False,5,9,4,200,True,False,200
LA1_1632142867,200,17391,16947,444,100,False,8,7,1,100,False,False,100
LA1_1637498742,200,16104,16096,8,100,False,5,5,0,0,False,True,200
LA1_1637728745,100,18313,16037,2276,100,False,8,6,2,100,True,True,100
LA1_1637638224,200,16174,17145,971,200,False,5,7,2,200,False,False,100
LA1_1637704612,100,15569,18550,2981,200,False,3,11,8,200,True,False,200
LA1_1634419110,200,16451,18196,1745,200,False,4,10,6,200,False,True,200
LA1_1638199329,100,17533,15192,2341,100,False,10,2,8,100,True,True,100
LA1_1640811442,100,17019,17131,112,200,False,7,5,2,100,True,True,100
LA1_1638444720,100,17546,16699,847,100,False,8,5,3,100,True,True,100
LA1_1638185601,200,15419,17173,1754,200,False,3,5,2,200,False,True,200
LA1_1641604798,100,16137,17555,1418,200,False,6,7,1,200,True,False,200
LA1_1638455513,200,16591,17657,1066,200,False,6,9,3,200,False,True,200
LA1_1640826172,200,16309,15105,1204,100,False,3,2,1,100,False,False,100
LA1_1639733348,100,17847,15708,2139,100,False,10,4,6,100,True,False,200
LA1_1641618158,200,15425,19148,3723,200,False,3,13,10,200,False,True,200
LA1_1644015252,200,17993,16275,1718,100,False,8,6,2,100,False,False,100
LA1_1644009763,200,16018,17939,1921,200,False,4,9,5,200,False,True,200
LA1_1631834169,100,17032,16467,565,100,False,7,5,2,100,True,True,100
LA1_1632732268,100,19066,14410,4656,100,False,8,2,6,100,True,True,100
LA1_1636147597,200,17533,18376,843,200,False,9,10,1,200,False,True,200
LA1_1631829369,100,15538,18728,3190,200,False,5,10,5,200,True,False,200
LA1_1632484454,100,16559,16608,49,200,False,6,5,1,100,True,False,200
LA1_1632330068,100,17452,18802,1350,200,False,6,11,5,200,True,True,100
LA1_1643636189,100,17080,16516,564,100,False,7,5,2,100,True,True,100
LA1_1633183567,100,15766,17345,1579,200,False,5,11,6,200,True,False,200
LA1_1633190264,100,16443,16397,46,100,False,6,5,1,100,True,False,200
LA1_1632493005,200,16381,17609,1228,200,False,5,7,2,200,False,True,200
LA1_1636136156,200,16783,17674,891,200,False,6,10,4,200,False,False,100
LA1_1628723639,100,15682,18777,3095,200,False,6,11,5,200,True,False,200
LA1_1628760400,200,17210,16357,853,100,False,7,3,4,100,False,False,100
LA1_1637149186,200,16900,17333,433,200,False,5,7,2,200,False,False,100
LA1_1637162226,200,16093,16844,751,200,False,4,7,3,200,False,True,200
LA1_1637831782,100,15572,15168,404,100,False,4,1,3,100,True,False,200
LA1_1637154745,100,16284,15788,496,100,False,5,5,0,0,False,True,100
LA1_1637133967,200,16534,15145,1389,100,False,7,1,6,100,False,False,100
LA1_1642011082,100,16406,19877,3471,200,False,6,14,8,200,True,False,200
LA1_1636865208,200,18052,13842,4210,100,False,10,0,10,100,False,False,100
LA1_1636441759,200,17351,16205,1146,100,False,6,6,0,0,False,False,100
LA1_1637167990,100,16463,18807,2344,200,False,7,9,2,200,True,False,200
LA1_1640075266,200,17104,15979,1125,100,False,10,5,5,100,False,False,100
LA1_1640067798,200,15858,15412,446,100,False,5,2,3,100,False,False,100
LA1_1633538973,200,15355,17886,2531,200,False,4,9,5,200,False,True,200
LA1_1633265618,100,16234,16211,23,100,False,6,7,1,200,True,False,200
LA1_1643421793,100,16723,16523,200,100,False,5,7,2,200,True,False,200
LA1_1633249424,100,17169,17342,173,200,False,6,6,0,0,False,True,100
LA1_1643396551,200,15643,17590,1947,200,False,4,7,3,200,False,True,200
LA1_1633536601,100,18825,15327,3498,100,False,11,3,8,100,True,True,100
LA1_1633530420,100,17059,16652,407,100,False,5,4,1,100,True,True,100
LA1_1636449619,100,16833,17700,867,200,False,7,10,3,200,True,False,200
LA1_1643411011,100,18764,18377,387,100,False,9,10,1,200,True,False,200
LA1_1633281215,100,16507,17043,536,200,False,4,6,2,200,True,False,200
LA1_1637224604,100,15088,15969,881,200,False,2,7,5,200,True,True,100
LA1_1622933262,100,16857,16361,496,100,False,6,6,0,0,False,False,200
LA1_1633984775,100,16259,18021,1762,200,False,5,9,4,200,True,True,100
LA1_1640404256,200,17636,17747,111,200,False,7,7,0,0,False,False,100
LA1_1628774617,100,14638,17495,2857,200,False,1,6,5,200,True,True,100
LA1_1633969858,100,17257,15559,1698,100,False,9,4,5,100,True,True,100
LA1_1633979194,100,19259,15539,3720,100,False,10,3,7,100,True,True,100
LA1_1627611072,200,16651,15094,1557,100,False,6,1,5,100,False,False,100
LA1_1627613534,200,16674,16566,108,100,False,6,3,3,100,False,True,200
LA1_1598732661,100,17281,15811,1470,100,False,8,4,4,100,True,False,200
LA1_1633960216,200,18722,17611,1111,100,False,11,8,3,100,False,False,100
LA1_1638990332,200,16905,17910,1005,200,False,8,8,0,0,False,True,200
LA1_1638979723,100,18754,15583,3171,100,False,11,4,7,100,True,True,100
LA1_1639006445,200,16293,16253,40,100,False,4,5,1,200,False,False,100
LA1_1633963027,100,16741,16133,608,100,False,7,5,2,100,True,True,100
LA1_1638995661,100,16125,15219,906,100,False,5,3,2,100,True,True,100
LA1_1633951214,200,17618,18105,487,200,False,7,10,3,200,False,False,100
LA1_1632712710,100,19269,17234,2035,100,False,9,9,0,0,False,True,100
LA1_1634697953,100,16116,16275,159,200,False,5,7,2,200,True,True,100
LA1_1635502058,100,16966,17625,659,200,False,7,8,1,200,True,False,200
LA1_1634707837,200,16043,18148,2105,200,False,8,6,2,100,False,True,200
LA1_1637269626,200,17822,14223,3599,100,False,7,1,6,100,False,False,100
LA1_1636860626,200,15741,18747,3006,200,False,5,10,5,200,False,True,200
LA1_1635647179,200,15878,17328,1450,200,False,5,7,2,200,False,True,200
LA1_1636487449,100,17234,16523,711,100,False,7,5,2,100,True,True,100
LA1_1637514206,200,16985,15918,1067,100,False,7,3,4,100,False,False,100
LA1_1634638349,100,18925,17218,1707,100,False,12,10,2,100,True,True,100
LA1_1638018057,100,15845,17728,1883,200,False,3,9,6,200,True,True,100
LA1_1636795741,200,19470,15456,4014,100,False,10,3,7,100,False,False,100
LA1_1635566173,200,14324,16374,2050,200,False,0,4,4,200,False,True,200
LA1_1633822460,200,19358,17767,1591,100,False,12,10,2,100,False,False,100
LA1_1633828674,200,15683,18469,2786,200,False,2,8,6,200,False,True,200
LA1_1637525989,100,17162,17355,193,200,False,7,7,0,0,False,True,100
LA1_1638002558,200,17376,19039,1663,200,False,7,13,6,200,False,True,200
LA1_1634651485,200,16730,16227,503,100,False,5,6,1,200,False,True,200
LA1_1636807128,200,16496,18233,1737,200,False,5,9,4,200,False,True,200
LA1_1641399580,200,17650,19578,1928,200,False,9,14,5,200,False,False,100
LA1_1640243046,100,15289,15964,675,200,False,4,5,1,200,True,True,100
LA1_1639984671,100,15861,15525,336,100,False,4,2,2,100,True,True,100
LA1_1635134442,200,18006,16986,1020,100,False,6,4,2,100,False,False,100
LA1_1640255714,200,17420,17119,301,100,False,10,8,2,100,False,True,200
LA1_1642360542,200,15381,16046,665,200,False,2,5,3,200,False,True,200
LA1_1639953295,200,14897,18217,3320,200,False,2,9,7,200,False,True,200
LA1_1631733470,100,14184,15793,1609,200,False,1,4,3,200,True,False,200
LA1_1642369732,200,17650,13686,3964,100,False,6,0,6,100,False,False,100
LA1_1639964913,100,16346,17722,1376,200,False,4,7,3,200,True,True,100
LA1_1636968345,200,17400,18205,805,200,False,9,8,1,100,False,True,200
LA1_1635658023,100,14754,17408,2654,200,False,3,9,6,200,True,False,200
LA1_1637498149,100,17144,16880,264,100,False,6,6,0,0,False,True,100
LA1_1635646146,100,15999,16188,189,200,False,5,5,0,0,False,True,100
LA1_1636971751,100,13774,16952,3178,200,False,1,5,4,200,True,False,200
LA1_1636770977,100,15995,15611,384,100,False,4,4,0,0,False,True,100
LA1_1633208785,100,16414,17734,1320,200,False,5,11,6,200,True,False,200
LA1_1633018949,200,16343,16439,96,200,False,4,5,1,200,False,True,200
LA1_1637508351,200,16710,16654,56,100,False,5,7,2,200,False,True,200
LA1_1632962897,200,16691,16932,241,200,False,6,4,2,100,False,False,100
LA1_1636555430,100,18160,17059,1101,100,False,9,7,2,100,True,True,100
LA1_1636527547,100,18685,15346,3339,100,False,9,3,6,100,True,True,100
LA1_1636278730,200,15294,18071,2777,200,False,1,7,6,200,False,True,200
LA1_1638431051,100,16582,14953,1629,100,False,4,2,2,100,True,True,100
LA1_1636290200,200,15582,15992,410,200,False,4,5,1,200,False,False,100
LA1_1636351380,200,16657,17109,452,200,False,8,7,1,100,False,True,200
LA1_1636169410,200,16512,17555,1043,200,False,4,7,3,200,False,True,200
LA1_1636298583,200,16270,20236,3966,200,False,5,14,9,200,False,True,200
LA1_1636537435,100,18310,18590,280,200,False,8,10,2,200,True,True,100
LA1_1636284711,100,16200,19685,3485,200,False,5,10,5,200,True,False,200
LA1_1636519632,100,15673,16736,1063,200,False,3,4,1,200,True,False,200
LA1_1636335771,100,17076,15727,1349,100,False,5,4,1,100,True,True,100
LA1_1643095982,200,16158,17495,1337,200,False,5,8,3,200,False,False,100
LA1_1643844361,100,15799,17957,2158,200,False,3,10,7,200,True,False,200
LA1_1636743788,200,16889,17401,512,200,False,7,6,1,100,False,True,200
LA1_1635836934,200,14203,20282,6079,200,False,1,12,11,200,False,True,200
LA1_1635818601,100,15244,16662,1418,200,False,2,6,4,200,True,True,100
LA1_1636109515,200,19093,16822,2271,100,False,9,6,3,100,False,False,100
LA1_1636152861,200,17281,16406,875,100,False,4,5,1,200,False,True,200
LA1_1636121243,200,15621,15525,96,100,False,3,1,2,100,False,False,100
LA1_1636760969,200,17484,17895,411,200,False,8,8,0,0,False,True,200
LA1_1636990029,100,16080,18223,2143,200,False,5,11,6,200,True,False,200
LA1_1637002350,200,15489,18169,2680,200,False,4,12,8,200,False,True,200
LA1_1637010808,200,14756,17347,2591,200,False,1,5,4,200,False,True,200
LA1_1636753179,200,13450,17177,3727,200,False,1,2,1,200,False,True,200
LA1_1643762130,200,16729,15689,1040,100,False,6,4,2,100,False,False,100
LA1_1643749879,200,16606,17664,1058,200,False,6,8,2,200,False,True,200
LA1_1643715176,200,15391,18098,2707,200,False,4,9,5,200,False,True,200
LA1_1643968513,100,18881,16593,2288,100,False,9,6,3,100,True,False,200
LA1_1643729970,100,17262,19310,2048,200,False,9,9,0,0,False,False,200
LA1_1643953859,200,17386,16246,1140,100,False,7,6,1,100,False,True,200
LA1_1643188376,100,18487,13668,4819,100,False,8,0,8,100,True,True,100
LA1_1643680622,100,16088,17182,1094,200,False,5,7,2,200,True,True,100
LA1_1643742520,200,17921,18778,857,200,False,8,11,3,200,False,True,200
LA1_1643208885,100,14154,17825,3671,200,False,1,6,5,200,True,False,200
LA1_1643694978,100,15235,16822,1587,200,False,1,5,4,200,True,True,100
LA1_1635905239,100,17472,18013,541,200,False,7,7,0,0,False,False,200
LA1_1635714687,200,17483,17117,366,100,False,10,9,1,100,False,True,200
LA1_1635711086,100,15936,16133,197,200,False,5,4,1,100,True,False,200
LA1_1635704349,100,17055,16575,480,100,False,7,6,1,100,True,True,100
LA1_1635458605,200,18471,18259,212,100,False,10,10,0,0,False,False,100
LA1_1635463019,100,18137,17200,937,100,False,10,8,2,100,True,True,100
LA1_1635927058,200,16872,16740,132,100,False,9,8,1,100,False,True,200
LA1_1635713427,200,15024,18310,3286,200,False,3,11,8,200,False,True,200
LA1_1635696188,100,15096,16584,1488,200,False,5,4,1,100,True,False,200
LA1_1635935989,200,16645,18196,1551,200,False,6,9,3,200,False,True,200
LA1_1635716630,200,17296,18528,1232,200,False,6,10,4,200,False,True,200
LA1_1644059723,100,17007,14822,2185,100,False,7,2,5,100,True,True,100
LA1_1643614951,100,15258,16076,818,200,False,2,5,3,200,True,True,100
LA1_1638383449,100,17356,20567,3211,200,False,8,15,7,200,True,True,100
LA1_1638470171,200,17100,18010,910,200,False,8,9,1,200,False,False,100
LA1_1643631637,100,18049,17125,924,100,False,9,8,1,100,True,True,100
LA1_1643657786,200,18159,16543,1616,100,False,9,5,4,100,False,True,200
LA1_1642378524,100,15518,19080,3562,200,False,4,12,8,200,True,False,200
LA1_1637900429,200,17548,15417,2131,100,False,8,3,5,100,False,False,100
LA1_1643872398,100,17428,15688,1740,100,False,7,4,3,100,True,True,100
LA1_1638457252,200,18226,18176,50,100,False,10,10,0,0,False,False,100
LA1_1643878984,100,14307,16591,2284,200,False,2,6,4,200,True,False,200
LA1_1643856418,100,18118,17018,1100,100,False,10,6,4,100,True,True,100
LA1_1643826542,200,17933,17390,543,100,False,11,8,3,100,False,False,100
LA1_1643089006,200,19646,16000,3646,100,False,10,5,5,100,False,False,100
LA1_1642209063,100,15491,16994,1503,200,False,5,7,2,200,True,True,100
LA1_1642188612,100,16168,15229,939,100,False,4,2,2,100,True,True,100
LA1_1641959291,100,16506,19621,3115,200,False,6,13,7,200,True,False,200
LA1_1636645827,200,15236,17478,2242,200,False,3,9,6,200,False,True,200
LA1_1641070087,100,15848,15514,334,100,False,4,3,1,100,True,True,100
LA1_1642202127,200,17171,16232,939,100,False,6,6,0,0,False,False,100
LA1_1642001227,100,17356,15079,2277,100,False,8,4,4,100,True,False,200
LA1_1641054392,100,17809,14295,3514,100,False,8,0,8,100,True,False,200
LA1_1641951530,200,15657,15362,295,100,False,3,2,1,100,False,False,100
LA1_1641081390,100,18712,16711,2001,100,False,10,6,4,100,True,False,200
LA1_1640848842,100,17369,15817,1552,100,False,5,4,1,100,True,False,200
LA1_1614604154,100,15596,17226,1630,200,False,3,7,4,200,True,False,200
LA1_1643137909,100,19076,15819,3257,100,False,9,6,3,100,True,True,100
LA1_1641936246,100,19694,18193,1501,100,False,12,11,1,100,True,True,100
LA1_1615535662,100,17800,18716,916,200,False,9,12,3,200,True,False,200
LA1_1608108475,100,18900,19637,737,200,False,13,11,2,100,True,True,100
LA1_1608610184,100,17747,16766,981,100,False,10,7,3,100,True,False,200
LA1_1615064555,200,14212,17877,3665,200,False,0,8,8,200,False,True,200
LA1_1642512314,200,14912,18320,3408,200,False,2,8,6,200,False,True,200
LA1_1641131657,100,18816,15560,3256,100,False,10,4,6,100,True,True,100
LA1_1642184779,200,16309,17566,1257,200,False,5,7,2,200,False,False,100
LA1_1638395756,100,15308,15123,185,100,False,3,2,1,100,True,False,200
LA1_1638522805,200,19058,14557,4501,100,False,8,1,7,100,False,False,100
LA1_1638450785,200,17501,16588,913,100,False,7,5,2,100,False,True,200
LA1_1638581049,100,15185,18505,3320,200,False,3,12,9,200,True,False,200
LA1_1638228839,200,16181,16465,284,200,False,3,4,1,200,False,True,200
LA1_1638559386,100,15316,17859,2543,200,False,3,7,4,200,True,True,100
LA1_1638596053,100,15752,15507,245,100,False,5,2,3,100,True,True,100
LA1_1639507882,200,18402,16774,1628,100,False,9,5,4,100,False,False,100
LA1_1638539841,100,15732,17689,1957,200,False,6,9,3,200,True,False,200
LA1_1638417733,200,17074,17375,301,200,False,7,7,0,0,False,True,200
LA1_1642242872,200,18760,16103,2657,100,False,8,6,2,100,False,False,100
LA1_1643232432,200,16938,14343,2595,100,False,5,2,3,100,False,False,100
LA1_1643099272,100,16950,18302,1352,200,False,6,9,3,200,True,False,200
LA1_1641780564,100,13702,17177,3475,200,False,1,6,5,200,True,False,200
LA1_1642254721,200,17393,14952,2441,100,False,5,4,1,100,False,False,100
LA1_1641772895,200,17700,15322,2378,100,False,6,4,2,100,False,False,100
LA1_1643197618,200,16787,15124,1663,100,False,4,2,2,100,False,False,100
LA1_1641528782,100,16624,18625,2001,200,False,6,11,5,200,True,True,100
LA1_1643218242,100,16965,15275,1690,100,False,7,3,4,100,True,True,100
LA1_1643087663,100,16532,16504,28,100,False,7,4,3,100,True,False,200
LA1_1642019680,100,16971,15096,1875,100,False,6,4,2,100,True,True,100
LA1_1632201052,200,17265,16240,1025,100,False,8,7,1,100,False,False,100
LA1_1629791054,200,17180,16146,1034,100,False,8,7,1,100,False,False,100
LA1_1634441454,100,17636,17954,318,200,False,6,8,2,200,True,True,100
LA1_1642769188,100,16143,19041,2898,200,False,5,12,7,200,True,False,200
LA1_1633128602,200,16643,17504,861,200,False,4,8,4,200,False,True,200
LA1_1632822976,100,18160,14962,3198,100,False,11,1,10,100,True,True,100
LA1_1633132599,100,18525,14938,3587,100,False,10,3,7,100,True,True,100
LA1_1629633759,100,17214,17604,390,200,False,8,12,4,200,True,True,100
LA1_1633136784,200,18505,16327,2178,100,False,10,6,4,100,False,True,200
LA1_1633150229,200,18298,17101,1197,100,False,8,6,2,100,False,False,100
LA1_1629647028,100,16850,17698,848,200,False,6,7,1,200,True,True,100
LA1_1641659076,200,15973,14970,1003,100,False,5,6,1,200,False,False,100
LA1_1634190428,100,19845,14956,4889,100,False,17,4,13,100,True,True,100
LA1_1632923574,100,15063,16910,1847,200,False,1,5,4,200,True,False,200
LA1_1638280740,200,16944,16460,484,100,False,6,4,2,100,False,False,100
LA1_1637100941,200,14836,17891,3055,200,False,1,10,9,200,False,True,200
LA1_1637110193,200,18430,16388,2042,100,False,11,5,6,100,False,False,100
LA1_1638311028,100,18495,17957,538,100,False,10,10,0,0,False,False,200
LA1_1638296855,100,17422,17287,135,100,False,11,7,4,100,True,False,200
LA1_1637116345,200,18563,16363,2200,100,False,11,6,5,100,False,False,100
LA1_1638246260,100,17153,18587,1434,200,False,6,12,6,200,True,True,100
LA1_1637566448,200,20348,14132,6216,100,False,12,2,10,100,False,False,100
LA1_1637582896,200,16606,14412,2194,100,False,6,1,5,100,False,False,100
LA1_1637577374,100,18245,18016,229,100,False,10,8,2,100,True,False,200
LA1_1638230834,200,17215,15275,1940,100,False,5,4,1,100,False,False,100
LA1_1635272615,200,17107,17417,310,200,False,7,7,0,0,False,True,200
LA1_1634332768,100,16816,19083,2267,200,False,5,12,7,200,True,False,200
LA1_1634349256,100,16477,18598,2121,200,False,5,11,6,200,True,False,200
LA1_1635546321,100,16519,14805,1714,100,False,6,1,5,100,True,True,100
LA1_1634339895,200,17653,16804,849,100,False,8,7,1,100,False,False,100
LA1_1634074000,100,15879,16603,724,200,False,3,6,3,200,True,False,200
LA1_1634911168,100,17756,17456,300,100,False,9,5,4,100,True,True,100
LA1_1634896679,100,15083,17090,2007,200,False,2,7,5,200,True,False,200
LA1_1633246030,100,15579,15525,54,100,False,3,3,0,0,False,True,100
LA1_1634017919,100,18072,16749,1323,100,False,8,5,3,100,True,True,100
LA1_1634932736,200,16451,15208,1243,100,False,4,1,3,100,False,True,200
LA1_1635285924,100,15507,17901,2394,200,False,3,9,6,200,True,False,200
LA1_1638446430,200,16820,14591,2229,100,False,5,2,3,100,False,False,100
LA1_1635746507,200,18460,15403,3057,100,False,7,4,3,100,False,False,100
LA1_1638401711,200,15432,18221,2789,200,False,3,8,5,200,False,False,100
LA1_1638676046,200,15668,16509,841,200,False,5,3,2,100,False,True,200
LA1_1638437635,200,17293,15526,1767,100,False,8,2,6,100,False,False,100
LA1_1638114716,100,14903,17178,2275,200,False,2,9,7,200,True,False,200
LA1_1635754310,100,19227,17855,1372,100,False,15,10,5,100,True,True,100
LA1_1635544522,100,16080,15634,446,100,False,4,2,2,100,True,False,200
LA1_1635009357,100,15377,15659,282,200,False,4,5,1,200,True,False,200
LA1_1638138779,200,17700,16262,1438,100,False,10,4,6,100,False,False,100
LA1_1638906560,200,17602,17200,402,100,False,8,4,4,100,False,False,100
LA1_1643689845,200,15212,16363,1151,200,False,2,5,3,200,False,True,200
LA1_1638500386,200,15517,18691,3174,200,False,3,10,7,200,False,True,200
LA1_1642043323,100,18035,18968,933,200,False,8,10,2,200,True,False,200
LA1_1642307636,100,19193,17206,1987,100,False,13,6,7,100,True,True,100
LA1_1642327161,100,17392,15593,1799,100,False,7,4,3,100,True,False,200
LA1_1642818198,100,17780,15598,2182,100,False,7,4,3,100,True,False,200
LA1_1642063771,200,16076,16174,98,200,False,3,5,2,200,False,True,200
LA1_1642037014,200,15123,18376,3253,200,False,3,8,5,200,False,True,200
LA1_1642055288,100,16987,16340,647,100,False,5,7,2,200,True,True,100
LA1_1642807278,100,18007,16340,1667,100,False,10,6,4,100,True,True,100
LA1_1642315898,100,16178,16185,7,200,False,3,4,1,200,True,False,200
LA1_1636069983,200,15187,21061,5874,200,False,3,13,10,200,False,True,200
LA1_1631892562,200,20721,14706,6015,100,False,16,2,14,100,False,False,100
LA1_1631342400,100,17534,16463,1071,100,False,7,4,3,100,True,True,100
LA1_1631878896,100,16213,17504,1291,200,False,6,9,3,200,True,False,200
LA1_1631634719,100,15796,17157,1361,200,False,5,7,2,200,True,True,100
LA1_1631873013,200,17417,16331,1086,100,False,7,5,2,100,False,True,200
LA1_1632978273,200,16344,17558,1214,200,False,4,8,4,200,False,True,200
LA1_1633007656,100,14792,18609,3817,200,False,2,9,7,200,True,True,100
LA1_1633018154,100,15113,17549,2436,200,False,3,9,6,200,True,False,200
LA1_1631331965,100,16112,19002,2890,200,False,4,12,8,200,True,False,200
LA1_1636082039,200,15861,16056,195,200,False,4,5,1,200,False,False,100
LA1_1643448473,200,16100,18116,2016,200,False,4,11,7,200,False,False,100
LA1_1643718055,200,15830,17238,1408,200,False,3,7,4,200,False,True,200
LA1_1644045895,100,17581,16995,586,100,False,6,6,0,0,False,True,100
LA1_1643914760,100,17769,18196,427,200,False,8,9,1,200,True,True,100
LA1_1643751982,100,17068,17385,317,200,False,8,9,1,200,True,True,100
LA1_1643462436,100,18288,18584,296,200,False,11,12,1,200,True,True,100
LA1_1643252641,200,14442,18923,4481,200,False,3,12,9,200,False,False,100
LA1_1643938301,200,16914,17585,671,200,False,7,9,2,200,False,False,100
LA1_1643762750,100,15447,15516,69,200,False,4,4,0,0,False,True,100
LA1_1635726665,200,14720,17782,3062,200,False,1,8,7,200,False,True,200
LA1_1635552215,200,18050,16145,1905,100,False,10,4,6,100,False,False,100
LA1_1635562122,200,16878,16090,788,100,False,6,4,2,100,False,True,200
LA1_1635579927,100,17930,15630,2300,100,False,9,4,5,100,True,True,100
LA1_1635612145,100,17616,16563,1053,100,False,8,7,1,100,True,False,200
LA1_1635596691,200,15770,18464,2694,200,False,6,12,6,200,False,False,100
LA1_1635529221,200,14511,17895,3384,200,False,2,8,6,200,False,True,200
LA1_1635730407,100,19550,15917,3633,100,False,13,4,9,100,True,True,100
LA1_1635725368,100,18014,16332,1682,100,False,11,6,5,100,True,True,100
LA1_1643904910,100,16811,17286,475,200,False,6,8,2,200,True,True,100
LA1_1643918982,200,14961,19028,4067,200,False,4,11,7,200,False,True,200
LA1_1643529059,100,15351,16637,1286,200,False,3,5,2,200,True,False,200
LA1_1637952807,100,15726,13905,1821,100,False,4,1,3,100,True,True,100
LA1_1637943962,200,15928,15369,559,100,False,4,2,2,100,False,False,100
LA1_1639449671,200,19235,17318,1917,100,False,14,7,7,100,False,False,100
LA1_1639482285,100,14832,18316,3484,200,False,2,9,7,200,True,False,200
LA1_1637501897,200,16093,16873,780,200,False,4,4,0,0,False,True,200
LA1_1637481494,100,18661,16457,2204,100,False,10,6,4,100,True,True,100
LA1_1636891581,200,13880,18149,4269,200,False,0,7,7,200,False,True,200
LA1_1636885611,100,15563,17455,1892,200,False,3,6,3,200,True,True,100
LA1_1639154838,100,17280,18437,1157,200,False,8,9,1,200,True,False,200
LA1_1639465819,200,16346,16074,272,100,False,5,4,1,100,False,False,100
LA1_1637490380,100,17576,15000,2576,100,False,5,2,3,100,True,False,200
LA1_1636303225,200,17903,18156,253,200,False,8,9,1,200,False,True,200
LA1_1640119646,200,16916,17607,691,200,False,8,6,2,100,False,False,100
LA1_1637780284,200,19241,14577,4664,100,False,10,4,6,100,False,False,100
LA1_1636310340,100,14876,15018,142,200,False,3,2,1,100,True,True,100
LA1_1637827301,200,14577,16731,2154,200,False,2,6,4,200,False,False,100
LA1_1637767173,100,16960,16350,610,100,False,7,6,1,100,True,True,100
LA1_1636293696,100,16756,15743,1013,100,False,7,5,2,100,True,True,100
LA1_1642029453,200,19506,15202,4304,100,False,9,3,6,100,False,False,100
LA1_1637787584,100,16002,16979,977,200,False,4,7,3,200,True,False,200
LA1_1636318287,100,16687,16062,625,100,False,7,4,3,100,True,True,100
LA1_1637799857,100,16904,19016,2112,200,False,6,10,4,200,True,True,100
LA1_1642524183,200,16184,19023,2839,200,False,4,11,7,200,False,True,200
LA1_1642261210,200,16154,14399,1755,100,False,6,2,4,100,False,True,200
LA1_1642084505,100,17855,15909,1946,100,False,8,3,5,100,True,True,100
LA1_1642356113,100,18123,19136,1013,200,False,11,10,1,100,True,True,100
LA1_1642508165,100,14674,16406,1732,200,False,1,3,2,200,True,False,200
LA1_1642502021,200,15579,16349,770,200,False,4,5,1,200,False,False,100
LA1_1642256280,200,18078,15873,2205,100,False,9,4,5,100,False,False,100
LA1_1642010632,100,16498,17170,672,200,False,7,6,1,100,True,False,200
LA1_1642515683,100,17682,16793,889,100,False,9,6,3,100,True,False,200
LA1_1642341787,100,15163,15695,532,200,False,3,7,4,200,True,False,200
LA1_1642015651,200,18520,16253,2267,100,False,9,6,3,100,False,True,200
LA1_1633781617,100,15854,16987,1133,200,False,5,7,2,200,True,True,100
LA1_1629073074,200,14324,18192,3868,200,False,1,8,7,200,False,False,100
LA1_1630535449,200,19945,18892,1053,100,False,15,10,5,100,False,False,100
LA1_1633779190,200,16426,17429,1003,200,False,6,6,0,0,False,True,200
LA1_1637137515,200,17458,16715,743,100,False,6,7,1,200,False,True,200
LA1_1637143407,100,17624,17222,402,100,False,7,4,3,100,True,False,200
LA1_1630393727,200,19261,18981,280,100,False,11,13,2,200,False,False,100
LA1_1637134833,100,15739,18098,2359,200,False,3,8,5,200,True,False,200
LA1_1630527603,200,17506,17457,49,100,False,9,8,1,100,False,False,100
LA1_1629088543,100,15490,15290,200,100,False,4,3,1,100,True,False,200
LA1_1629111755,100,16378,16787,409,200,False,3,6,3,200,True,True,100
LA1_1636033698,200,14977,18608,3631,200,False,3,10,7,200,False,True,200
LA1_1636065926,200,16408,14883,1525,100,False,5,4,1,100,False,False,100
LA1_1636055025,100,15927,16835,908,200,False,5,6,1,200,True,True,100
LA1_1637508629,200,18528,18120,408,100,False,10,9,1,100,False,False,100
LA1_1637078646,100,16079,15291,788,100,False,6,3,3,100,True,False,200
LA1_1637032839,100,16290,16860,570,200,False,2,7,5,200,True,False,200
LA1_1637022293,200,15862,17207,1345,200,False,3,7,4,200,False,False,100
LA1_1637011205,200,17130,17889,759,200,False,7,8,1,200,False,True,200
LA1_1637000530,100,18092,20072,1980,200,False,9,14,5,200,True,True,100
LA1_1637612177,200,17393,16890,503,100,False,9,9,0,0,False,False,100
LA1_1637066686,200,14563,16622,2059,200,False,1,3,2,200,False,False,100
LA1_1637053423,200,18200,14981,3219,100,False,10,4,6,100,False,False,100
LA1_1637520336,200,15476,17716,2240,200,False,3,8,5,200,False,True,200
LA1_1637606761,200,16874,16783,91,100,False,7,4,3,100,False,False,100
LA1_1643360862,200,18068,15180,2888,100,False,9,2,7,100,False,False,100
LA1_1642557553,200,17510,16728,782,100,False,7,6,1,100,False,False,100
LA1_1642550482,100,17438,18865,1427,200,False,9,12,3,200,True,False,200
LA1_1642499086,100,16591,15786,805,100,False,4,5,1,200,True,False,200
LA1_1642246578,200,14712,17057,2345,200,False,3,7,4,200,False,True,200
LA1_1643368306,200,18914,16890,2024,100,False,10,8,2,100,False,False,100
LA1_1642290921,200,15845,16436,591,200,False,4,5,1,200,False,True,200
LA1_1642263323,200,16218,17337,1119,200,False,4,8,4,200,False,True,200
LA1_1642325979,100,15315,17568,2253,200,False,3,8,5,200,True,True,100
LA1_1643312640,200,16713,15785,928,100,False,5,4,1,100,False,False,100
LA1_1642301245,200,17268,15348,1920,100,False,7,3,4,100,False,False,100
LA1_1642588243,200,15646,16291,645,200,False,3,5,2,200,False,False,100
LA1_1642540816,100,16638,15755,883,100,False,4,2,2,100,True,False,200
LA1_1643378133,200,16161,15768,393,100,False,6,4,2,100,False,True,200
LA1_1643317413,200,15638,17803,2165,200,False,4,7,3,200,False,True,200
LA1_1642272495,100,17524,16504,1020,100,False,8,7,1,100,True,True,100
LA1_1642599252,200,15891,14230,1661,100,False,3,0,3,100,False,False,100
LA1_1642565396,200,17101,16381,720,100,False,6,6,0,0,False,False,100
LA1_1643302474,100,16898,15901,997,100,False,5,4,1,100,True,True,100
LA1_1642239509,100,17039,15011,2028,100,False,9,4,5,100,True,True,100
LA1_1631877297,100,20672,18070,2602,100,False,15,11,4,100,True,True,100
LA1_1634047859,200,15724,16725,1001,200,False,2,4,2,200,False,False,100
LA1_1630547232,100,15900,13598,2302,100,False,6,1,5,100,True,True,100
LA1_1630777851,200,17658,15668,1990,100,False,7,5,2,100,False,False,100
LA1_1634362457,200,15695,16591,896,200,False,3,6,3,200,False,True,200
LA1_1632185170,200,18050,15239,2811,100,False,8,4,4,100,False,False,100
LA1_1630349834,100,14884,17082,2198,200,False,2,5,3,200,True,False,200
LA1_1632171994,100,16779,15138,1641,100,False,6,3,3,100,True,True,100
LA1_1631451314,200,17095,15497,1598,100,False,6,2,4,100,False,False,100
LA1_1633420329,200,16455,17468,1013,200,False,6,8,2,200,False,True,200
LA1_1634588033,200,16248,16858,610,200,False,3,7,4,200,False,False,100
LA1_1630109139,200,18573,16158,2415,100,False,7,7,0,0,False,True,200
LA1_1632161264,100,16833,17040,207,200,False,8,7,1,100,True,False,200
LA1_1630760654,200,16511,15693,818,100,False,3,5,2,200,False,False,100
LA1_1632996870,200,16417,14772,1645,100,False,3,3,0,0,False,False,100
LA1_1632193867,100,16686,19315,2629,200,False,5,10,5,200,True,False,200
LA1_1633781051,100,16095,17554,1459,200,False,5,8,3,200,True,False,200
LA1_1630767535,200,18328,18230,98,100,False,11,10,1,100,False,True,200
LA1_1631664815,200,14994,16005,1011,200,False,2,5,3,200,False,True,200
LA1_1642403968,200,17351,15696,1655,100,False,8,5,3,100,False,True,200
LA1_1642519531,100,18603,17071,1532,100,False,12,6,6,100,True,True,100
LA1_1643475687,200,14524,16548,2024,200,False,3,3,0,0,False,True,200
LA1_1643424315,200,16302,16138,164,100,False,5,3,2,100,False,True,200
LA1_1643503671,200,20485,15226,5259,100,False,16,5,11,100,False,False,100
LA1_1643640851,100,17333,15466,1867,100,False,10,5,5,100,True,True,100
LA1_1643253184,200,17625,15188,2437,100,False,8,5,3,100,False,True,200
LA1_1643636342,200,16001,18967,2966,200,False,7,12,5,200,False,True,200
LA1_1635854081,100,16947,17024,77,200,False,7,8,1,200,True,False,200
LA1_1635636988,200,15080,15807,727,200,False,4,4,0,0,False,False,100
LA1_1641984965,100,16979,17801,822,200,False,7,8,1,200,True,False,200
LA1_1634497201,200,17836,18277,441,200,False,6,10,4,200,False,False,100
LA1_1635596470,200,16034,14705,1329,100,False,7,4,3,100,False,True,200
LA1_1634695313,100,16908,15394,1514,100,False,7,4,3,100,True,True,100
LA1_1634498474,200,15832,17182,1350,200,False,3,4,1,200,False,False,100
LA1_1629323122,100,16356,17315,959,200,False,5,7,2,200,True,False,200
LA1_1634497549,200,15419,15449,30,200,False,5,4,1,100,False,False,100
LA1_1629633126,100,18071,17324,747,100,False,10,7,3,100,True,False,200
LA1_1635652488,200,16189,15032,1157,100,False,4,2,2,100,False,False,100
LA1_1634709305,200,14436,18931,4495,200,False,1,10,9,200,False,True,200
LA1_1629327686,100,17259,16109,1150,100,False,6,4,2,100,True,False,200
LA1_1634701666,200,16306,17810,1504,200,False,5,8,3,200,False,True,200
LA1_1634682350,200,15048,17455,2407,200,False,4,8,4,200,False,True,200
LA1_1641783012,200,15630,15493,137,100,False,5,4,1,100,False,False,100
LA1_1641788300,100,17028,17206,178,200,False,7,10,3,200,True,True,100
LA1_1634495102,100,17775,18074,299,200,False,9,9,0,0,False,False,200
LA1_1641990810,200,16024,17673,1649,200,False,5,9,4,200,False,True,200
LA1_1635621730,200,17281,15959,1322,100,False,10,5,5,100,False,True,200
LA1_1640436416,200,18122,14215,3907,100,False,6,2,4,100,False,False,100
LA1_1640163482,100,16227,16990,763,200,False,5,6,1,200,True,True,100
LA1_1641541072,200,17357,17273,84,100,False,7,7,0,0,False,False,100
LA1_1641532195,100,17764,15760,2004,100,False,8,5,3,100,True,True,100
LA1_1641234153,200,17267,18851,1584,200,False,6,7,1,200,False,True,200
LA1_1640152363,100,16865,17418,553,200,False,7,6,1,100,True,True,100
LA1_1641245028,100,15344,16482,1138,200,False,2,6,4,200,True,False,200
LA1_1640442714,100,18337,15838,2499,100,False,10,5,5,100,True,True,100
LA1_1639871997,200,16658,15457,1201,100,False,6,2,4,100,False,True,200
LA1_1641548663,200,15179,17601,2422,200,False,1,7,6,200,False,False,100
LA1_1641221608,100,15217,14887,330,100,False,3,2,1,100,True,True,100
LA1_1640722536,100,15806,15993,187,200,False,4,4,0,0,False,False,200
LA1_1639884614,100,15938,15403,535,100,False,3,4,1,200,True,True,100
LA1_1640955938,200,16638,16273,365,100,False,6,5,1,100,False,True,200
LA1_1640945857,200,16089,16106,17,200,False,5,6,1,200,False,True,200
LA1_1635343945,100,16424,17921,1497,200,False,6,9,3,200,True,True,100
LA1_1639276523,100,16367,17582,1215,200,False,5,7,2,200,True,True,100
LA1_1637469362,200,14640,16548,1908,200,False,2,6,4,200,False,False,100
LA1_1640677214,100,15931,16701,770,200,False,5,7,2,200,True,False,200
LA1_1636246403,200,15988,16031,43,200,False,5,3,2,100,False,True,200
LA1_1636253542,200,16484,19322,2838,200,False,4,10,6,200,False,True,200
LA1_1636237021,100,17924,16520,1404,100,False,10,8,2,100,True,True,100
LA1_1636536193,200,15718,16611,893,200,False,5,6,1,200,False,False,100
LA1_1636240700,200,15653,17510,1857,200,False,4,9,5,200,False,True,200
LA1_1638493868,200,20369,16298,4071,100,False,13,5,8,100,False,False,100
LA1_1636973110,200,17078,15637,1441,100,False,6,3,3,100,False,True,200
LA1_1637372582,200,15268,17118,1850,200,False,3,9,6,200,False,True,200
LA1_1637478606,200,17203,17821,618,200,False,8,7,1,100,False,True,200
LA1_1636258947,100,16999,17437,438,200,False,8,9,1,200,True,True,100
LA1_1636526265,100,16332,17339,1007,200,False,6,6,0,0,False,True,100
LA1_1640682544,100,17258,15266,1992,100,False,7,4,3,100,True,True,100
LA1_1637376723,100,15591,18315,2724,200,False,3,8,5,200,True,False,200
LA1_1636094832,100,15488,14737,751,100,False,3,2,1,100,True,True,100
LA1_1638939820,200,17270,15573,1697,100,False,6,4,2,100,False,False,100
LA1_1638978469,200,16068,15885,183,100,False,6,3,3,100,False,False,100
LA1_1639271959,100,16132,17229,1097,200,False,3,8,5,200,True,False,200
LA1_1638968925,100,18016,16014,2002,100,False,9,3,6,100,True,True,100
LA1_1638780835,100,16211,19402,3191,200,False,6,13,7,200,True,False,200
LA1_1639334207,200,16700,17081,381,200,False,5,7,2,200,False,True,200
LA1_1638937790,100,16439,17816,1377,200,False,7,8,1,200,True,True,100
LA1_1639016672,100,16730,15800,930,100,False,5,3,2,100,True,True,100
LA1_1639241694,200,18264,15811,2453,100,False,9,5,4,100,False,True,200
LA1_1638806265,200,16659,19136,2477,200,False,8,12,4,200,False,True,200
LA1_1638943832,200,17165,16599,566,100,False,8,6,2,100,False,False,100
LA1_1639055311,100,16273,16407,134,200,False,5,7,2,200,True,False,200
LA1_1639245919,100,18029,14905,3124,100,False,7,2,5,100,True,True,100
LA1_1639240194,100,15879,16368,489,200,False,4,5,1,200,True,False,200
LA1_1639091967,100,15006,15717,711,200,False,3,4,1,200,True,False,200
LA1_1639107251,200,17533,19563,2030,200,False,8,13,5,200,False,False,100
LA1_1638984943,200,15076,15356,280,200,False,2,3,1,200,False,True,200
LA1_1639008352,100,15435,16561,1126,200,False,2,5,3,200,True,False,200
LA1_1633925933,200,15323,18342,3019,200,False,4,6,2,200,False,True,200
LA1_1636318255,100,17104,17781,677,200,False,8,10,2,200,True,False,200
LA1_1633150325,200,13978,19256,5278,200,False,1,14,13,200,False,True,200
LA1_1633576619,100,17421,18699,1278,200,False,9,13,4,200,True,False,200
LA1_1632931558,100,16460,15506,954,100,False,4,2,2,100,True,True,100
LA1_1632844655,200,18438,17628,810,100,False,10,7,3,100,False,False,100
LA1_1638268611,200,16398,16772,374,200,False,5,6,1,200,False,False,100
LA1_1635411452,100,15616,16845,1229,200,False,4,6,2,200,True,False,200
LA1_1638284304,100,19374,15385,3989,100,False,11,3,8,100,True,True,100
LA1_1634470055,100,14165,18184,4019,200,False,1,8,7,200,True,False,200
LA1_1637302800,200,16372,16804,432,200,False,5,8,3,200,False,True,200
LA1_1634479392,200,16409,16199,210,100,False,5,6,1,200,False,False,100
LA1_1633515059,200,17765,15135,2630,100,False,10,3,7,100,False,False,100
LA1_1635434740,200,17102,15918,1184,100,False,5,5,0,0,False,True,200
LA1_1633502756,100,16571,17085,514,200,False,4,5,1,200,True,False,200
LA1_1635426045,200,15970,17613,1643,200,False,4,6,2,200,False,True,200
LA1_1639430049,200,16644,16595,49,100,False,7,5,2,100,False,False,100
LA1_1633402697,100,14940,16656,1716,200,False,3,7,4,200,True,False,200
LA1_1636054078,100,16984,16427,557,100,False,7,6,1,100,True,True,100
LA1_1635998144,200,15199,17060,1861,200,False,5,6,1,200,False,True,200
LA1_1633489936,100,15582,16595,1013,200,False,5,5,0,0,False,True,100
LA1_1634271833,200,17313,18440,1127,200,False,7,9,2,200,False,True,200
LA1_1633470065,100,15982,16058,76,200,False,4,3,1,100,True,True,100
LA1_1636046386,100,18207,15919,2288,100,False,7,2,5,100,True,False,200
LA1_1633410533,100,17595,15765,1830,100,False,9,4,5,100,True,True,100
LA1_1634455846,200,17749,17395,354,100,False,8,8,0,0,False,False,100
LA1_1629032980,200,15977,18252,2275,200,False,4,8,4,200,False,False,100
LA1_1633569370,100,18029,16542,1487,100,False,9,5,4,100,True,False,200
LA1_1632007528,100,15931,16297,366,200,False,5,5,0,0,False,True,100
LA1_1630046255,100,16662,15999,663,100,False,7,5,2,100,True,True,100
LA1_1634835879,100,17135,15990,1145,100,False,8,4,4,100,True,False,200
LA1_1634826974,100,18307,16860,1447,100,False,9,6,3,100,True,True,100
LA1_1633313862,100,17304,15855,1449,100,False,8,6,2,100,True,True,100
LA1_1635509124,200,19294,17395,1899,100,False,12,9,3,100,False,True,200
LA1_1633573593,200,14935,15000,65,200,False,3,4,1,200,False,False,100
LA1_1633768726,200,17554,16880,674,100,False,7,7,0,0,False,False,100
LA1_1635528394,100,16329,14633,1696,100,False,2,0,2,100,True,True,100
LA1_1631155327,200,18114,16085,2029,100,False,11,3,8,100,False,False,100
LA1_1634820044,200,17954,16592,1362,100,False,11,8,3,100,False,True,200
LA1_1634752278,200,15873,14688,1185,100,False,4,4,0,0,False,True,200
LA1_1634757412,100,16884,19238,2354,200,False,8,12,4,200,True,True,100
LA1_1634744572,200,17132,17591,459,200,False,7,9,2,200,False,True,200
LA1_1631979385,200,16888,16681,207,100,False,8,6,2,100,False,False,100
LA1_1629301131,200,18390,17312,1078,100,False,10,7,3,100,False,True,200
LA1_1631151209,200,17442,15899,1543,100,False,7,5,2,100,False,False,100
LA1_1635517657,200,16188,17736,1548,200,False,4,8,4,200,False,True,200
LA1_1635193945,200,16434,16057,377,100,False,6,6,0,0,False,True,200
LA1_1634933461,200,17304,18687,1383,200,False,7,12,5,200,False,True,200
LA1_1635188380,200,15491,18236,2745,200,False,4,9,5,200,False,True,200
LA1_1634428388,100,16856,16369,487,100,False,8,5,3,100,True,True,100
LA1_1632587971,200,15948,15339,609,100,False,4,3,1,100,False,True,200
LA1_1634945335,100,15752,16370,618,200,False,4,6,2,200,True,False,200
LA1_1634443719,100,15137,15747,610,200,False,4,3,1,100,True,False,200
LA1_1632601788,200,15788,17943,2155,200,False,6,9,3,200,False,True,200
LA1_1626502519,200,18619,16077,2542,100,False,12,5,7,100,False,False,100
LA1_1622131284,100,18581,18391,190,100,False,13,9,4,100,True,False,200
LA1_1622412443,200,16856,18882,2026,200,False,6,11,5,200,False,True,200
LA1_1622427770,200,17396,17248,148,100,False,8,10,2,200,False,True,200
LA1_1622439646,100,17581,17658,77,200,False,10,6,4,100,True,True,100
LA1_1622126313,100,15632,15122,510,100,False,4,3,1,100,True,True,100
LA1_1627273985,100,19232,18548,684,100,False,11,9,2,100,True,True,100
LA1_1620954184,100,16571,17744,1173,200,False,5,7,2,200,True,False,200
LA1_1622136982,200,18530,18010,520,100,False,10,9,1,100,False,True,200
LA1_1619762168,100,16484,16560,76,200,False,7,5,2,100,True,False,200
LA1_1626382581,100,17511,16949,562,100,False,9,7,2,100,True,True,100
LA1_1622117516,100,16397,16674,277,200,False,6,5,1,100,True,True,100
LA1_1626929361,200,16526,16029,497,100,False,5,3,2,100,False,True,200
LA1_1620413903,200,17021,17289,268,200,False,7,8,1,200,False,False,100
LA1_1620964031,100,14893,18859,3966,200,False,2,8,6,200,True,False,200
LA1_1622448599,100,19103,16450,2653,100,False,12,6,6,100,True,True,100
LA1_1622909229,200,16427,17424,997,200,False,3,8,5,200,False,True,200
LA1_1627442117,200,18176,15902,2274,100,False,6,4,2,100,False,True,200
LA1_1626507951,200,18540,16829,1711,100,False,11,7,4,100,False,True,200
LA1_1625446106,200,16066,17974,1908,200,False,4,6,2,200,False,True,200
LA1_1636932659,100,17871,16332,1539,100,False,7,5,2,100,True,True,100
LA1_1637977574,200,15309,15810,501,200,False,3,3,0,0,False,False,100
LA1_1636750170,100,17984,17223,761,100,False,9,7,2,100,True,False,200
LA1_1636958409,200,16977,14887,2090,100,False,6,3,3,100,False,False,100
LA1_1637763993,200,15846,17343,1497,200,False,5,6,1,200,False,True,200
LA1_1636939699,200,15574,17964,2390,200,False,4,10,6,200,False,True,200
LA1_1636952190,200,18399,19670,1271,200,False,10,13,3,200,False,False,100
LA1_1636642467,200,17592,16834,758,100,False,8,6,2,100,False,True,200
LA1_1636865859,200,17587,15427,2160,100,False,10,4,6,100,False,True,200
LA1_1637780537,200,16684,15163,1521,100,False,6,4,2,100,False,True,200
LA1_1636657893,100,15279,15902,623,200,False,0,4,4,200,True,True,100
LA1_1636653121,200,19356,14771,4585,100,False,9,2,7,100,False,False,100
LA1_1636767256,100,15934,17150,1216,200,False,2,7,5,200,True,False,200
LA1_1636757717,200,16111,15013,1098,100,False,5,3,2,100,False,False,100
LA1_1636946235,100,20934,15075,5859,100,False,10,4,6,100,True,True,100
LA1_1638002088,100,19328,16178,3150,100,False,10,7,3,100,True,True,100
LA1_1637751816,200,16976,15245,1731,100,False,4,2,2,100,False,False,100
LA1_1636853785,100,15084,18912,3828,200,False,3,9,6,200,True,False,200
LA1_1637987868,200,16367,17105,738,200,False,7,5,2,100,False,False,100
LA1_1635388403,200,18056,16720,1336,100,False,11,6,5,100,False,False,100
LA1_1634196268,100,17165,17413,248,200,False,9,6,3,100,True,True,100
LA1_1636179416,200,16654,15810,844,100,False,4,2,2,100,False,False,100
LA1_1635647946,200,15631,15709,78,200,False,4,5,1,200,False,False,100
LA1_1635152843,100,15514,16800,1286,200,False,3,5,2,200,True,False,200
LA1_1630403631,200,18478,13952,4526,100,False,9,0,9,100,False,False,100
LA1_1634786326,100,17088,16274,814,100,False,5,4,1,100,True,False,200
LA1_1629225186,200,17955,17407,548,100,False,8,7,1,100,False,False,100
LA1_1637808949,100,18252,17549,703,100,False,10,7,3,100,True,True,100
LA1_1634714614,200,16204,18041,1837,200,False,7,8,1,200,False,True,200
LA1_1642446431,100,17510,16289,1221,100,False,6,3,3,100,True,True,100
LA1_1637837798,200,14527,16350,1823,200,False,1,4,3,200,False,True,200
LA1_1637834008,100,16315,16674,359,200,False,3,5,2,200,True,False,200
LA1_1637706241,200,16336,15354,982,100,False,6,2,4,100,False,False,100
LA1_1637825630,200,18305,15855,2450,100,False,10,3,7,100,False,False,100
LA1_1637815914,100,18519,15915,2604,100,False,9,5,4,100,True,True,100
LA1_1640058666,200,16701,16367,334,100,False,5,5,0,0,False,False,100
LA1_1637609556,200,17706,18500,794,200,False,8,9,1,200,False,False,100
LA1_1634707960,100,18038,16660,1378,100,False,6,6,0,0,False,True,100
LA1_1635965094,200,18275,17116,1159,100,False,9,9,0,0,False,False,100
LA1_1637834835,100,18040,17920,120,100,False,8,8,0,0,False,False,200
LA1_1642437377,100,16071,18602,2531,200,False,8,12,4,200,True,False,200
LA1_1634700471,200,16109,15927,182,100,False,4,4,0,0,False,True,200
LA1_1637829466,100,17463,17325,138,100,False,8,7,1,100,True,False,200
LA1_1637835996,100,16691,16658,33,100,False,4,6,2,200,True,True,100
LA1_1637837128,200,17332,18717,1385,200,False,8,8,0,0,False,False,100
LA1_1637715635,100,14575,17740,3165,200,False,3,9,6,200,True,False,200
LA1_1637831513,200,16585,16306,279,100,False,5,4,1,100,False,True,200
LA1_1641126991,100,18533,14226,4307,100,False,8,1,7,100,True,False,200
LA1_1642372772,200,16894,16882,12,100,False,6,7,1,200,False,False,100
LA1_1640972799,200,14442,16039,1597,200,False,2,5,3,200,False,True,200
LA1_1641090570,200,17010,15509,1501,100,False,6,3,3,100,False,True,200
LA1_1640980898,200,15975,16925,950,200,False,6,11,5,200,False,False,100
LA1_1641229627,100,14622,17334,2712,200,False,0,5,5,200,True,True,100
LA1_1641008918,100,15098,16554,1456,200,False,1,5,4,200,True,True,100
LA1_1640945745,200,16604,18515,1911,200,False,6,8,2,200,False,True,200
LA1_1640992071,200,16948,18267,1319,200,False,7,11,4,200,False,True,200
LA1_1641214804,100,16580,17957,1377,200,False,5,8,3,200,True,False,200
LA1_1641115775,200,16305,16344,39,200,False,4,4,0,0,False,True,200
LA1_1641021680,100,17881,15092,2789,100,False,8,4,4,100,True,True,100
LA1_1640934387,200,16588,15003,1585,100,False,7,2,5,100,False,True,200
LA1_1641036003,100,16427,16518,91,200,False,5,5,0,0,False,False,200
LA1_1641101766,200,17148,17291,143,200,False,7,5,2,100,False,True,200
LA1_1641047656,200,20308,18561,1747,100,False,13,11,2,100,False,False,100
LA1_1641253281,100,14751,16641,1890,200,False,2,5,3,200,True,False,200
LA1_1641140347,200,18296,14976,3320,100,False,11,4,7,100,False,False,100
LA1_1640999970,200,17975,16106,1869,100,False,8,4,4,100,False,False,100
LA1_1641220810,100,17556,14308,3248,100,False,6,2,4,100,True,True,100
LA1_1642244886,100,15180,18233,3053,200,False,5,10,5,200,True,False,200
LA1_1642739318,200,17328,14676,2652,100,False,7,4,3,100,False,True,200
LA1_1642735557,200,18093,16633,1460,100,False,10,5,5,100,False,True,200
LA1_1642563580,100,17099,17019,80,100,False,7,7,0,0,False,False,200
LA1_1642587170,200,22463,15862,6601,100,False,19,7,12,100,False,False,100
LA1_1642595598,100,15297,16866,1569,200,False,4,6,2,200,True,True,100
LA1_1642088502,200,16375,17972,1597,200,False,7,7,0,0,False,True,200
LA1_1627523255,200,17058,15290,1768,100,False,6,4,2,100,False,False,100
LA1_1634840042,100,17017,15689,1328,100,False,6,3,3,100,True,True,100
LA1_1635646882,200,17580,16236,1344,100,False,7,4,3,100,False,True,200
LA1_1637811155,100,16151,18632,2481,200,False,4,11,7,200,True,False,200
LA1_1627532402,100,15622,16746,1124,200,False,2,5,3,200,True,False,200
LA1_1627508701,200,16652,14545,2107,100,False,7,3,4,100,False,False,100
LA1_1637801658,100,17394,16929,465,100,False,6,7,1,200,True,False,200
LA1_1627479260,100,15199,16842,1643,200,False,3,6,3,200,True,False,200
LA1_1637826054,100,16581,17949,1368,200,False,6,12,6,200,True,False,200
LA1_1627422952,100,18177,18202,25,200,False,8,8,0,0,False,False,200
LA1_1627414044,200,20035,16144,3891,100,False,13,7,6,100,False,True,200
LA1_1635632494,200,15441,15104,337,100,False,1,3,2,200,False,False,100
LA1_1627403980,200,17599,15086,2513,100,False,10,2,8,100,False,False,100
LA1_1627434217,200,15677,17500,1823,200,False,4,6,2,200,False,True,200
LA1_1627544236,100,15549,19411,3862,200,False,3,10,7,200,True,False,200
LA1_1637821235,200,18337,16304,2033,100,False,10,5,5,100,False,False,100
LA1_1637792267,100,16629,16772,143,200,False,3,6,3,200,True,False,200
LA1_1635623681,100,16151,20679,4528,200,False,7,13,6,200,True,False,200
LA1_1628534368,100,15304,14253,1051,100,False,5,2,3,100,True,True,100
LA1_1627506690,200,18903,15090,3813,100,False,9,2,7,100,False,False,100
LA1_1627832495,200,16280,17848,1568,200,False,6,7,1,200,False,True,200
LA1_1629157426,100,18118,15904,2214,100,False,9,3,6,100,True,True,100
LA1_1627816875,200,14959,15450,491,200,False,1,3,2,200,False,True,200
LA1_1628029204,100,15698,16450,752,200,False,3,7,4,200,True,False,200
LA1_1628011491,100,17343,17096,247,100,False,9,8,1,100,True,True,100
LA1_1628499334,200,17327,16118,1209,100,False,8,4,4,100,False,True,200
LA1_1627843573,200,15277,15825,548,200,False,5,5,0,0,False,True,200
LA1_1628702201,100,18665,16507,2158,100,False,11,5,6,100,True,True,100
LA1_1629120796,200,15866,16864,998,200,False,4,5,1,200,False,True,200
LA1_1628549630,200,15746,18413,2667,200,False,6,9,3,200,False,False,100
LA1_1627807620,200,16535,16924,389,200,False,6,6,0,0,False,False,100
LA1_1628001216,200,14937,15852,915,200,False,4,6,2,200,False,True,200
LA1_1627965693,100,16711,16627,84,100,False,8,6,2,100,True,True,100
LA1_1628710279,100,14754,17632,2878,200,False,2,4,2,200,True,False,200
LA1_1628517289,100,16595,17351,756,200,False,4,7,3,200,True,False,200
LA1_1627788551,200,15418,16763,1345,200,False,3,7,4,200,False,True,200
LA1_1627855141,100,16647,17582,935,200,False,5,8,3,200,True,True,100
LA1_1629135632,200,16795,16926,131,200,False,7,4,3,100,False,True,200
LA1_1619380821,200,18793,16500,2293,100,False,11,6,5,100,False,False,100
LA1_1617969765,100,15680,16244,564,200,False,4,6,2,200,True,True,100
LA1_1619553013,200,17918,15047,2871,100,False,9,4,5,100,False,False,100
LA1_1613319088,100,17804,15972,1832,100,False,8,5,3,100,True,True,100
LA1_1617992665,100,14510,17833,3323,200,False,3,8,5,200,True,True,100
LA1_1613321397,100,18662,16719,1943,100,False,14,6,8,100,True,False,200
LA1_1618591971,200,15843,14944,899,100,False,4,2,2,100,False,False,100
LA1_1637361523,100,17230,16721,509,100,False,8,5,3,100,True,True,100
LA1_1637844347,100,16200,15270,930,100,False,5,3,2,100,True,True,100
LA1_1637407735,100,17480,15894,1586,100,False,8,5,3,100,True,True,100
LA1_1637385591,200,15835,15736,99,100,False,5,4,1,100,False,False,100
LA1_1637393129,100,16688,16113,575,100,False,6,4,2,100,True,True,100
LA1_1637429860,200,18370,18751,381,200,False,10,13,3,200,False,True,200
LA1_1638098748,100,19653,15583,4070,100,False,10,4,6,100,True,True,100
LA1_1637422121,100,16745,14468,2277,100,False,6,2,4,100,True,True,100
LA1_1637379283,200,16270,17488,1218,200,False,8,11,3,200,False,False,100
LA1_1637887242,100,16491,17076,585,200,False,8,7,1,100,True,True,100
LA1_1638135771,100,18538,15324,3214,100,False,10,3,7,100,True,True,100
LA1_1638079891,200,16925,15427,1498,100,False,7,4,3,100,False,True,200
LA1_1637989792,100,15293,18041,2748,200,False,5,9,4,200,True,False,200
LA1_1637364108,100,16402,15820,582,100,False,6,3,3,100,True,True,100
LA1_1637846035,100,14476,16765,2289,200,False,4,8,4,200,True,True,100
LA1_1638089519,100,15963,15399,564,100,False,4,5,1,200,True,True,100
LA1_1638244273,200,19463,16328,3135,100,False,14,5,9,100,False,False,100
LA1_1638078165,100,17323,18018,695,200,False,10,11,1,200,True,False,200
LA1_1638086074,100,16845,14737,2108,100,False,9,2,7,100,True,True,100
LA1_1636282476,200,15840,18006,2166,200,False,4,7,3,200,False,True,200
LA1_1637481719,200,17643,16199,1444,100,False,10,6,4,100,False,True,200
LA1_1637764535,200,15757,15503,254,100,False,2,3,1,200,False,True,200
LA1_1635843225,100,17520,16737,783,100,False,8,3,5,100,True,False,200
LA1_1636143621,200,16306,15212,1094,100,False,2,1,1,100,False,True,200
LA1_1636274623,200,16607,16227,380,100,False,4,4,0,0,False,False,100
LA1_1636157966,100,16816,16074,742,100,False,6,5,1,100,True,False,200
LA1_1637470119,100,14518,14792,274,200,False,2,2,0,0,False,False,200
LA1_1637653531,200,15101,17567,2466,200,False,3,9,6,200,False,True,200
LA1_1637644430,200,15802,18433,2631,200,False,4,10,6,200,False,True,200
LA1_1637647620,200,17886,13932,3954,100,False,8,1,7,100,False,False,100
LA1_1636182766,100,16836,17410,574,200,False,6,8,2,200,True,True,100
LA1_1636113054,200,18743,17884,859,100,False,12,7,5,100,False,True,200
LA1_1637775457,200,16318,15404,914,100,False,4,3,1,100,False,False,100
LA1_1637793015,200,17344,16055,1289,100,False,6,4,2,100,False,True,200
LA1_1636127951,200,17812,14138,3674,100,False,7,1,6,100,False,False,100
LA1_1637492270,100,16388,16522,134,200,False,5,5,0,0,False,True,100
LA1_1637449987,200,16997,16671,326,100,False,6,5,1,100,False,False,100
LA1_1636172868,100,14801,15908,1107,200,False,3,4,1,200,True,False,200
LA1_1637460424,100,17310,18816,1506,200,False,9,9,0,0,False,True,100
LA1_1633375841,100,18783,16790,1993,100,False,13,7,6,100,True,False,200
LA1_1631239829,200,15701,17239,1538,200,False,3,6,3,200,False,True,200
LA1_1631223142,100,19506,19998,492,200,False,13,13,0,0,False,True,100
LA1_1631275882,100,18625,15341,3284,100,False,9,3,6,100,True,False,200
LA1_1631414913,200,17822,16053,1769,100,False,9,5,4,100,False,True,200
LA1_1632214119,100,18291,14446,3845,100,False,9,3,6,100,True,True,100
LA1_1631246963,200,17689,19608,1919,200,False,7,13,6,200,False,True,200
LA1_1632195095,100,16692,17586,894,200,False,5,6,1,200,True,True,100
LA1_1640847127,200,16557,17491,934,200,False,6,6,0,0,False,False,100
LA1_1641315881,200,16711,16592,119,100,False,8,6,2,100,False,False,100
LA1_1632595444,100,17855,14555,3300,100,False,9,3,6,100,True,True,100
LA1_1640860013,100,16849,16388,461,100,False,7,5,2,100,True,True,100
LA1_1641256555,200,15608,16292,684,200,False,3,2,1,100,False,True,200
LA1_1641245612,100,16635,17132,497,200,False,5,8,3,200,True,True,100
LA1_1641238387,100,16539,18829,2290,200,False,6,11,5,200,True,False,200
LA1_1633642665,200,16904,16465,439,100,False,5,5,0,0,False,True,200
LA1_1638032016,200,17897,15701,2196,100,False,9,3,6,100,False,False,100
LA1_1632606719,100,16475,15884,591,100,False,6,3,3,100,True,False,200
LA1_1633083697,100,18182,15729,2453,100,False,10,4,6,100,True,True,100
LA1_1641208527,100,14702,17519,2817,200,False,4,6,2,200,True,False,200
LA1_1633429597,100,17163,16127,1036,100,False,7,5,2,100,True,False,200
LA1_1640594295,200,17063,18060,997,200,False,6,8,2,200,False,False,100
LA1_1634148086,100,15644,17413,1769,200,False,3,8,5,200,True,True,100
LA1_1638311017,200,15222,16416,1194,200,False,4,7,3,200,False,True,200
LA1_1638015809,200,16073,16289,216,200,False,4,4,0,0,False,False,100
LA1_1640869926,200,16951,15945,1006,100,False,6,5,1,100,False,False,100
LA1_1638294702,200,18194,17009,1185,100,False,12,5,7,100,False,True,200
LA1_1641331243,200,19078,18124,954,100,False,11,9,2,100,False,True,200
LA1_1635688408,200,14754,17079,2325,200,False,4,5,1,200,False,True,200
LA1_1635554105,100,15427,17434,2007,200,False,4,6,2,200,True,False,200
LA1_1635485713,200,17362,16940,422,100,False,6,5,1,100,False,True,200
LA1_1635433205,100,16613,16233,380,100,False,4,5,1,200,True,True,100
LA1_1635425073,200,17895,16505,1390,100,False,7,5,2,100,False,False,100
LA1_1635375104,200,15876,16143,267,200,False,5,7,2,200,False,True,200
LA1_1635663779,200,16092,17323,1231,200,False,7,7,0,0,False,True,200
LA1_1636372753,100,14928,17240,2312,200,False,2,9,7,200,True,True,100
LA1_1635676179,200,15260,15832,572,200,False,1,3,2,200,False,False,100
LA1_1635564601,100,16170,17292,1122,200,False,5,6,1,200,True,True,100
LA1_1637145457,200,16507,15004,1503,100,False,6,3,3,100,False,False,100
LA1_1635655292,200,17843,16532,1311,100,False,7,5,2,100,False,False,100
LA1_1635411841,200,16040,17668,1628,200,False,7,8,1,200,False,True,200
LA1_1635642332,100,17314,16048,1266,100,False,7,5,2,100,True,False,200
LA1_1635558459,200,15783,18542,2759,200,False,4,10,6,200,False,True,200
LA1_1635500650,100,15729,16355,626,200,False,6,4,2,100,True,True,100
LA1_1635625720,100,16956,16543,413,100,False,4,6,2,200,True,True,100
LA1_1637047134,100,17746,17253,493,100,False,8,7,1,100,True,True,100
LA1_1635306111,100,17927,16936,991,100,False,8,7,1,100,True,False,200
LA1_1635296873,100,16568,15625,943,100,False,4,3,1,100,True,True,100
LA1_1635587150,200,15245,17823,2578,200,False,2,10,8,200,False,True,200
LA1_1636100325,100,18629,16253,2376,100,False,9,3,6,100,True,False,200
LA1_1641321315,200,18989,15571,3418,100,False,10,5,5,100,False,False,100
LA1_1636109647,100,14108,17286,3178,200,False,2,6,4,200,True,False,200
LA1_1641330454,100,18980,15576,3404,100,False,12,3,9,100,True,False,200
LA1_1640184705,100,13684,19251,5567,200,False,2,13,11,200,True,False,200
LA1_1640194088,200,18558,16714,1844,100,False,6,7,1,200,False,False,100
LA1_1643520507,100,18526,17342,1184,100,False,10,6,4,100,True,True,100
LA1_1641957740,200,17085,16749,336,100,False,6,6,0,0,False,True,200
LA1_1643592683,200,15560,18478,2918,200,False,4,11,7,200,False,True,200
LA1_1642194447,100,16622,16603,19,100,False,8,5,3,100,True,True,100
LA1_1642289149,200,16576,14967,1609,100,False,6,3,3,100,False,True,200
LA1_1643536816,200,14450,18140,3690,200,False,3,10,7,200,False,True,200
LA1_1643528434,100,17129,15105,2024,100,False,9,4,5,100,True,False,200
LA1_1642201898,200,14584,14950,366,200,False,0,1,1,200,False,False,100
LA1_1642304959,100,15289,16059,770,200,False,3,7,4,200,True,False,200
LA1_1643606487,100,17839,17548,291,100,False,10,6,4,100,True,True,100
LA1_1643535543,200,16220,14475,1745,100,False,5,2,3,100,False,True,200
LA1_1643600727,100,17568,18823,1255,200,False,8,11,3,200,True,False,200
LA1_1641955430,100,16871,17938,1067,200,False,8,9,1,200,True,False,200
LA1_1641524700,100,17058,16813,245,100,False,7,8,1,200,True,False,200
LA1_1641456755,100,17505,15064,2441,100,False,8,4,4,100,True,False,200
LA1_1642282294,200,16400,16642,242,200,False,4,5,1,200,False,False,100
LA1_1641517702,100,16759,16771,12,200,False,7,7,0,0,False,False,200
LA1_1642295874,200,17843,14345,3498,100,False,9,2,7,100,False,True,200
LA1_1642208302,100,17267,17565,298,200,False,8,6,2,100,True,False,200
LA1_1642212363,100,15572,16202,630,200,False,5,5,0,0,False,False,200
LA1_1632203524,200,16088,17526,1438,200,False,2,5,3,200,False,True,200
LA1_1632209568,200,16260,16193,67,100,False,6,6,0,0,False,False,100
LA1_1631742164,100,16216,17573,1357,200,False,4,6,2,200,True,True,100
LA1_1629724327,100,16392,16361,31,100,False,3,3,0,0,False,True,100
LA1_1631538783,200,18608,15889,2719,100,False,9,4,5,100,False,True,200
LA1_1632415218,200,16359,16678,319,200,False,5,7,2,200,False,False,100
LA1_1627984717,200,17740,14350,3390,100,False,10,1,9,100,False,False,100
LA1_1632355843,200,17392,15681,1711,100,False,8,5,3,100,False,False,100
LA1_1632421494,100,16878,15356,1522,100,False,5,4,1,100,True,False,200
LA1_1632214874,100,17274,18632,1358,200,False,7,8,1,200,True,False,200
LA1_1635891014,100,16719,16758,39,200,False,5,5,0,0,False,True,100
LA1_1627753274,100,16395,16792,397,200,False,4,7,3,200,True,False,200
LA1_1631514722,100,17104,16885,219,100,False,7,8,1,200,True,True,100
LA1_1631956336,100,16789,15714,1075,100,False,5,3,2,100,True,True,100
LA1_1631527264,100,15746,15685,61,100,False,4,2,2,100,True,True,100
LA1_1630380979,200,17055,17023,32,100,False,5,7,2,200,False,False,100
LA1_1627767166,200,15013,14532,481,100,False,3,2,1,100,False,False,100
LA1_1627978207,100,18208,17005,1203,100,False,11,6,5,100,True,True,100
LA1_1632405396,200,18556,16736,1820,100,False,11,6,5,100,False,True,200
LA1_1626995526,100,16352,17391,1039,200,False,6,9,3,200,True,True,100
LA1_1635771693,200,18839,15595,3244,100,False,7,3,4,100,False,False,100
LA1_1635595659,200,17041,15908,1133,100,False,6,4,2,100,False,False,100
LA1_1635479628,100,15498,16692,1194,200,False,5,6,1,200,True,True,100
LA1_1635264025,100,17955,18956,1001,200,False,8,12,4,200,True,False,200
LA1_1635503392,100,17432,18583,1151,200,False,8,10,2,200,True,True,100
LA1_1635491620,200,16139,16168,29,200,False,6,6,0,0,False,False,100
LA1_1635290814,200,17141,15408,1733,100,False,8,2,6,100,False,False,100
LA1_1635285125,100,15410,16649,1239,200,False,4,7,3,200,True,True,100
LA1_1632316390,100,18115,16741,1374,100,False,10,7,3,100,True,True,100
LA1_1632963119,100,19229,18287,942,100,False,12,10,2,100,True,True,100
LA1_1632302110,200,15987,17323,1336,200,False,4,6,2,200,False,True,200
LA1_1632291482,200,17227,18904,1677,200,False,7,11,4,200,False,False,100
LA1_1630491247,200,16058,16667,609,200,False,4,5,1,200,False,True,200
LA1_1630498080,200,15789,15707,82,100,False,3,4,1,200,False,False,100
LA1_1630702637,200,18032,17349,683,100,False,8,7,1,100,False,False,100
LA1_1632778179,100,14467,17360,2893,200,False,2,9,7,200,True,False,200
LA1_1628138849,100,18002,16930,1072,100,False,12,9,3,100,True,True,100
LA1_1628123738,200,17332,17804,472,200,False,9,11,2,200,False,True,200
LA1_1628150217,200,16275,17348,1073,200,False,4,7,3,200,False,True,200
LA1_1632967781,200,17024,15296,1728,100,False,6,3,3,100,False,False,100
LA1_1630485676,200,16654,16371,283,100,False,5,3,2,100,False,True,200
LA1_1628129670,100,19554,18778,776,100,False,15,13,2,100,True,True,100
LA1_1632794617,200,15786,17163,1377,200,False,2,6,4,200,False,True,200
LA1_1632308208,100,16654,15335,1319,100,False,7,5,2,100,True,True,100
LA1_1628133826,200,16108,17257,1149,200,False,4,7,3,200,False,True,200
LA1_1632786255,200,15702,16442,740,200,False,5,5,0,0,False,True,200
LA1_1630707911,100,16277,16936,659,200,False,4,7,3,200,True,False,200
LA1_1628153961,200,17220,14951,2269,100,False,7,2,5,100,False,False,100
LA1_1624862608,100,16085,17475,1390,200,False,3,10,7,200,True,True,100
LA1_1626911263,200,17989,19055,1066,200,False,9,13,4,200,False,True,200
LA1_1625496481,100,18396,15567,2829,100,False,9,4,5,100,True,False,200
LA1_1626447327,200,19212,19131,81,100,False,12,10,2,100,False,True,200
LA1_1624969625,200,16868,17784,916,200,False,5,7,2,200,False,False,100
LA1_1629666036,200,16832,18215,1383,200,False,7,9,2,200,False,True,200
LA1_1628489778,200,18391,17695,696,100,False,11,8,3,100,False,False,100
LA1_1626335842,200,17730,16787,943,100,False,8,5,3,100,False,False,100
LA1_1626352001,100,17478,15941,1537,100,False,7,5,2,100,True,True,100
LA1_1625353998,200,15335,17535,2200,200,False,3,7,4,200,False,True,200
LA1_1624853351,200,17406,18743,1337,200,False,7,9,2,200,False,True,200
LA1_1626115189,200,15920,18311,2391,200,False,3,7,4,200,False,True,200
LA1_1624992146,200,16501,16038,463,100,False,7,5,2,100,False,True,200
LA1_1632111845,200,15053,17659,2606,200,False,3,10,7,200,False,False,100
LA1_1631912928,100,19065,15372,3693,100,False,11,5,6,100,True,True,100
LA1_1626324627,100,15556,16802,1246,200,False,3,5,2,200,True,False,200
LA1_1628481529,200,18331,13815,4516,100,False,9,3,6,100,False,False,100
LA1_1624890456,100,17214,16674,540,100,False,8,7,1,100,True,True,100
LA1_1624979727,100,15376,16120,744,200,False,2,4,2,200,True,False,200
LA1_1637935165,200,18073,14783,3290,100,False,7,3,4,100,False,False,100
LA1_1630357627,100,14996,18853,3857,200,False,6,12,6,200,True,False,200
LA1_1628202755,200,17151,16785,366,100,False,7,6,1,100,False,False,100
LA1_1630369095,100,15371,14894,477,100,False,2,1,1,100,True,True,100
LA1_1637922714,200,16504,16712,208,200,False,6,10,4,200,False,False,100
LA1_1628104724,100,17501,15646,1855,100,False,9,6,3,100,True,True,100
LA1_1628216155,100,15513,16912,1399,200,False,3,7,4,200,True,False,200
LA1_1629884156,200,16982,15747,1235,100,False,6,4,2,100,False,True,200
LA1_1636595018,200,17544,17289,255,100,False,6,8,2,200,False,True,200
LA1_1638480240,200,18101,18839,738,200,False,8,12,4,200,False,True,200
LA1_1637690500,100,18767,16690,2077,100,False,12,7,5,100,True,True,100
LA1_1636066829,200,17377,17278,99,100,False,8,8,0,0,False,True,200
LA1_1641491802,100,14888,16348,1460,200,False,1,4,3,200,True,False,200
LA1_1636579419,200,17540,15761,1779,100,False,10,6,4,100,False,True,200
LA1_1641486459,200,17950,17491,459,100,False,10,8,2,100,False,True,200
LA1_1636312205,100,16877,17635,758,200,False,6,7,1,200,True,True,100
LA1_1636087862,200,16826,16689,137,100,False,6,6,0,0,False,False,100
LA1_1641500554,100,15376,15824,448,200,False,1,4,3,200,True,True,100
LA1_1636076826,200,16167,15829,338,100,False,6,4,2,100,False,True,200
LA1_1638818855,200,17890,15396,2494,100,False,9,3,6,100,False,False,100
LA1_1638197889,200,17050,17711,661,200,False,6,10,4,200,False,False,100
LA1_1638376844,200,17861,18852,991,200,False,9,13,4,200,False,False,100
LA1_1639570691,100,16435,15772,663,100,False,5,3,2,100,True,True,100
LA1_1637698928,200,15722,17715,1993,200,False,4,7,3,200,False,True,200
LA1_1636562212,200,18044,16993,1051,100,False,10,7,3,100,False,True,200
LA1_1638833790,100,16920,17236,316,200,False,7,7,0,0,False,False,200
LA1_1636319814,200,17060,17212,152,200,False,9,6,3,100,False,False,100
LA1_1638469427,100,16337,15653,684,100,False,4,4,0,0,False,True,100
LA1_1640392831,100,16104,17335,1231,200,False,6,7,1,200,True,False,200
LA1_1640240309,200,14875,15871,996,200,False,4,6,2,200,False,True,200
LA1_1641540819,200,14984,18519,3535,200,False,4,14,10,200,False,True,200
LA1_1640306433,200,16744,16657,87,100,False,7,7,0,0,False,True,200
LA1_1640385070,200,16498,15779,719,100,False,5,4,1,100,False,False,100
LA1_1640273820,200,17173,16587,586,100,False,7,4,3,100,False,True,200
LA1_1641560077,200,18096,17727,369,100,False,10,8,2,100,False,True,200
LA1_1641885435,200,14734,15437,703,200,False,1,3,2,200,False,False,100
LA1_1640379568,100,17079,17256,177,200,False,8,7,1,100,True,False,200
LA1_1641979547,100,16061,16229,168,200,False,6,5,1,100,True,False,200
LA1_1641513702,100,16605,15871,734,100,False,6,3,3,100,True,False,200
LA1_1641900932,100,17147,16626,521,100,False,8,6,2,100,True,False,200
LA1_1640258157,200,16646,14341,2305,100,False,8,2,6,100,False,False,100
LA1_1641589408,200,18020,17089,931,100,False,10,8,2,100,False,False,100
LA1_1641573941,100,16144,16586,442,200,False,8,7,1,100,True,True,100
LA1_1641535280,100,16700,17768,1068,200,False,5,8,3,200,True,False,200
LA1_1640294286,100,18234,15316,2918,100,False,8,3,5,100,True,True,100
LA1_1641526755,200,18875,15938,2937,100,False,10,3,7,100,False,False,100
LA1_1641549372,200,16506,18343,1837,200,False,6,11,5,200,False,True,200
LA1_1617438460,200,16307,16394,87,200,False,5,3,2,100,False,True,200
LA1_1616754298,200,16844,17493,649,200,False,8,8,0,0,False,False,100
LA1_1617393647,200,16885,18052,1167,200,False,7,12,5,200,False,True,200
LA1_1614944354,200,16164,15020,1144,100,False,5,3,2,100,False,True,200
LA1_1615822609,200,17908,16416,1492,100,False,9,6,3,100,False,False,100
LA1_1621342167,100,16574,15336,1238,100,False,6,3,3,100,True,True,100
LA1_1617386175,200,15502,16623,1121,200,False,5,4,1,100,False,True,200
LA1_1627183823,100,14899,18147,3248,200,False,2,11,9,200,True,False,200
LA1_1623988132,200,16055,16787,732,200,False,4,6,2,200,False,True,200
LA1_1625734137,200,16650,15852,798,100,False,6,4,2,100,False,False,100
LA1_1622424445,200,17190,16465,725,100,False,6,6,0,0,False,False,100
LA1_1625790739,200,16432,15924,508,100,False,6,5,1,100,False,True,200
LA1_1624414348,200,17032,18058,1026,200,False,8,9,1,200,False,True,200
LA1_1622765911,100,13856,17770,3914,200,False,2,7,5,200,True,False,200
LA1_1624964890,200,18100,16131,1969,100,False,12,4,8,100,False,True,200
LA1_1621567770,200,15959,16681,722,200,False,5,5,0,0,False,False,100
LA1_1625820401,100,16831,17741,910,200,False,5,8,3,200,True,True,100
LA1_1624424139,200,16559,16642,83,200,False,6,6,0,0,False,True,200
LA1_1621400425,200,16406,17815,1409,200,False,7,11,4,200,False,True,200
LA1_1624950557,100,16732,15071,1661,100,False,5,3,2,100,True,False,200
LA1_1625898941,200,17532,16711,821,100,False,9,8,1,100,False,False,100
LA1_1625886775,200,17247,16527,720,100,False,8,5,3,100,False,False,100
LA1_1625781245,100,17042,16420,622,100,False,6,5,1,100,True,False,200
LA1_1622779393,200,18255,17148,1107,100,False,11,5,6,100,False,False,100
LA1_1621393571,200,19551,15344,4207,100,False,16,4,12,100,False,False,100
LA1_1625741157,100,17933,15318,2615,100,False,10,5,5,100,True,True,100
LA1_1625811051,100,17222,16201,1021,100,False,5,6,1,200,True,False,200
LA1_1625802807,200,15935,19123,3188,200,False,6,11,5,200,False,True,200
LA1_1618122253,100,16692,14513,2179,100,False,5,1,4,100,True,True,100
LA1_1619224179,200,20940,16232,4708,100,False,17,6,11,100,False,False,100
LA1_1618786140,200,16576,16022,554,100,False,7,5,2,100,False,True,200
LA1_1618147463,200,18438,16213,2225,100,False,8,5,3,100,False,True,200
LA1_1619283954,200,17500,16984,516,100,False,9,6,3,100,False,False,100
LA1_1619198462,200,20034,15177,4857,100,False,14,3,11,100,False,True,200
LA1_1618159310,200,18398,15101,3297,100,False,9,2,7,100,False,False,100
LA1_1619229033,100,16682,17843,1161,200,False,8,9,1,200,True,False,200
LA1_1620206118,100,16367,16739,372,200,False,5,6,1,200,True,False,200
LA1_1619216477,100,15837,19500,3663,200,False,5,11,6,200,True,False,200
LA1_1619270641,200,14676,17413,2737,200,False,3,6,3,200,False,True,200
LA1_1619239010,200,17360,17863,503,200,False,7,8,1,200,False,False,100
LA1_1619063309,200,17725,14763,2962,100,False,6,3,3,100,False,True,200
LA1_1619045209,100,17147,16253,894,100,False,6,5,1,100,True,True,100
LA1_1619075115,100,16642,16397,245,100,False,6,4,2,100,True,True,100
LA1_1619242879,100,15552,17277,1725,200,False,5,9,4,200,True,False,200
LA1_1619208901,200,16303,20411,4108,200,False,6,14,8,200,False,False,100
LA1_1619050688,200,17482,14898,2584,100,False,7,2,5,100,False,False,100
LA1_1619650230,100,16954,17061,107,200,False,8,5,3,100,True,True,100
LA1_1626428715,100,16373,15503,870,100,False,8,5,3,100,True,False,200
LA1_1630305966,200,18179,17773,406,100,False,9,6,3,100,False,False,100
LA1_1631912055,200,14680,18330,3650,200,False,3,8,5,200,False,True,200
LA1_1632262989,100,17472,17201,271,100,False,9,8,1,100,True,True,100
LA1_1630656347,100,19254,13945,5309,100,False,9,3,6,100,True,True,100
LA1_1631924703,100,20083,17480,2603,100,False,15,10,5,100,True,True,100
LA1_1630313316,100,17978,17537,441,100,False,7,8,1,200,True,False,200
LA1_1630289070,100,18274,16168,2106,100,False,6,6,0,0,False,True,100
LA1_1632153346,100,18577,16575,2002,100,False,8,3,5,100,True,True,100
LA1_1627641578,100,19072,15858,3214,100,False,10,3,7,100,True,True,100
LA1_1629577069,200,16001,16816,815,200,False,4,5,1,200,False,False,100
LA1_1630698102,200,17046,18912,1866,200,False,6,11,5,200,False,True,200
LA1_1628820285,100,16626,15493,1133,100,False,5,3,2,100,True,True,100
LA1_1628820989,200,15635,16561,926,200,False,3,5,2,200,False,False,100
LA1_1630701792,100,18124,16196,1928,100,False,8,5,3,100,True,False,200
LA1_1627652701,200,16285,17381,1096,200,False,7,8,1,200,False,True,200
LA1_1627647404,200,18292,16928,1364,100,False,7,7,0,0,False,True,200
LA1_1627481166,200,21809,17272,4537,100,False,20,9,11,100,False,False,100
LA1_1627075586,200,16889,16231,658,100,False,6,4,2,100,False,False,100
LA1_1635008411,100,17166,19945,2779,200,False,5,12,7,200,True,False,200
LA1_1627062152,100,18598,16618,1980,100,False,11,7,4,100,True,False,200
LA1_1630035389,200,18701,17574,1127,100,False,8,7,1,100,False,True,200
LA1_1627762342,100,18881,15418,3463,100,False,9,2,7,100,True,False,200
LA1_1631863031,100,18045,17294,751,100,False,7,7,0,0,False,False,200
LA1_1633821423,200,15772,16288,516,200,False,5,6,1,200,False,False,100
LA1_1627737236,200,15815,15895,80,200,False,3,5,2,200,False,True,200
LA1_1627749352,200,16060,16028,32,100,False,4,4,0,0,False,True,200
LA1_1633813380,200,16603,17517,914,200,False,5,9,4,200,False,True,200
LA1_1628174852,200,19144,18774,370,100,False,9,9,0,0,False,True,200
LA1_1627945519,200,18487,15789,2698,100,False,9,3,6,100,False,False,100
LA1_1627954129,200,18385,17325,1060,100,False,11,9,2,100,False,True,200
LA1_1626949808,100,19907,17621,2286,100,False,16,10,6,100,True,True,100
LA1_1626740054,100,18269,16131,2138,100,False,9,4,5,100,True,True,100
LA1_1627975918,200,16534,16880,346,200,False,4,6,2,200,False,False,100
LA1_1628206830,200,18344,17709,635,100,False,11,9,2,100,False,False,100
LA1_1629066295,200,15115,16055,940,200,False,3,3,0,0,False,True,200
LA1_1628198170,200,16700,15022,1678,100,False,8,2,6,100,False,True,200
LA1_1626711774,200,16768,15990,778,100,False,5,4,1,100,False,True,200
LA1_1626727807,100,17101,17843,742,200,False,8,9,1,200,True,True,100
LA1_1628200644,100,14744,17434,2690,200,False,2,6,4,200,True,False,200
LA1_1628415320,100,15517,15555,38,200,False,4,4,0,0,False,True,100
LA1_1630791087,200,16312,15886,426,100,False,6,3,3,100,False,True,200
LA1_1627969421,200,15833,16640,807,200,False,4,5,1,200,False,True,200
LA1_1627961333,100,17603,17264,339,100,False,8,7,1,100,True,True,100
LA1_1628183612,100,15951,14636,1315,100,False,4,1,3,100,True,True,100
LA1_1628854046,200,17162,18468,1306,200,False,5,10,5,200,False,True,200
LA1_1629882822,100,18302,16001,2301,100,False,8,4,4,100,True,True,100
LA1_1630856814,200,16950,19829,2879,200,False,6,12,6,200,False,False,100
LA1_1629175436,200,17207,17235,28,200,False,7,5,2,100,False,False,100
LA1_1630842280,200,18098,19092,994,200,False,8,12,4,200,False,True,200
LA1_1630868212,100,17835,15486,2349,100,False,7,4,3,100,True,True,100
LA1_1632886349,100,17481,15814,1667,100,False,6,3,3,100,True,True,100
LA1_1622550114,200,19679,15188,4491,100,False,10,3,7,100,False,False,100
LA1_1622315847,100,19072,18690,382,100,False,9,10,1,200,True,False,200
LA1_1622291908,100,17073,16072,1001,100,False,7,6,1,100,True,True,100
LA1_1625568435,100,17662,15250,2412,100,False,7,4,3,100,True,True,100
LA1_1622404902,100,16655,17516,861,200,False,7,7,0,0,False,True,100
LA1_1621947972,200,16988,21492,4504,200,False,8,18,10,200,False,True,200
LA1_1622473460,100,15981,15957,24,100,False,6,5,1,100,True,False,200
LA1_1623304527,100,15003,15367,364,200,False,1,3,2,200,True,False,200
LA1_1625575658,100,15663,16048,385,200,False,4,4,0,0,False,True,100
LA1_1622708523,100,17997,17022,975,100,False,8,6,2,100,True,False,200
LA1_1623780234,100,16037,17580,1543,200,False,6,7,1,200,True,False,200
LA1_1622175228,100,16536,15649,887,100,False,6,5,1,100,True,True,100
LA1_1622307225,100,18798,18304,494,100,False,12,11,1,100,True,True,100
LA1_1621956802,200,17923,16982,941,100,False,7,6,1,100,False,False,100
LA1_1622050872,200,17542,18596,1054,200,False,9,11,2,200,False,True,200
LA1_1623107923,200,16470,15803,667,100,False,7,6,1,100,False,False,100
LA1_1622466246,100,17773,17819,46,200,False,11,9,2,100,True,True,100
LA1_1635974918,100,18246,16801,1445,100,False,10,6,4,100,True,True,100
LA1_1636850501,100,17813,17715,98,100,False,9,9,0,0,False,False,200
LA1_1635963969,100,17925,17752,173,100,False,9,8,1,100,True,False,200
LA1_1635956169,200,16248,16822,574,200,False,3,4,1,200,False,False,100
LA1_1636700863,100,16909,16108,801,100,False,5,5,0,0,False,True,100
LA1_1636861313,100,17863,15666,2197,100,False,8,5,3,100,True,True,100
LA1_1636873427,100,15037,17280,2243,200,False,2,8,6,200,True,False,200
LA1_1635970580,100,15423,16115,692,200,False,3,5,2,200,True,True,100
LA1_1636608421,200,15913,16092,179,200,False,2,3,1,200,False,False,100
LA1_1636825634,200,15393,18517,3124,200,False,3,9,6,200,False,True,200
LA1_1636885782,200,18900,18179,721,100,False,12,10,2,100,False,True,200
LA1_1636795443,100,16194,15656,538,100,False,8,3,5,100,True,True,100
LA1_1636841085,100,16016,20607,4591,200,False,6,12,6,200,True,False,200
LA1_1636811932,100,16881,15508,1373,100,False,4,4,0,0,False,True,100
LA1_1636784908,100,17175,16570,605,100,False,7,5,2,100,True,False,200
LA1_1635983241,100,15190,18868,3678,200,False,3,11,8,200,True,False,200
LA1_1636580288,100,18603,15553,3050,100,False,8,2,6,100,True,True,100
LA1_1635980246,100,16152,16342,190,200,False,4,3,1,100,True,True,100
LA1_1636291630,200,18556,17111,1445,100,False,10,4,6,100,False,True,200
LA1_1636880639,200,17030,18665,1635,200,False,5,9,4,200,False,True,200
LA1_1637198437,100,16624,18073,1449,200,False,6,8,2,200,True,False,200
LA1_1636480562,100,17543,15325,2218,100,False,7,7,0,0,False,True,100
LA1_1637178377,200,16434,15507,927,100,False,3,2,1,100,False,False,100
LA1_1637579101,100,16805,16213,592,100,False,8,3,5,100,True,True,100
LA1_1637203796,100,16082,18017,1935,200,False,6,11,5,200,True,False,200
LA1_1636502724,100,17006,15511,1495,100,False,7,5,2,100,True,True,100
LA1_1638195495,200,17904,15818,2086,100,False,8,5,3,100,False,False,100
LA1_1623174532,200,18156,15914,2242,100,False,10,5,5,100,False,True,200
LA1_1623197604,100,17349,15466,1883,100,False,8,4,4,100,True,True,100
LA1_1623415382,200,15712,15421,291,100,False,4,3,1,100,False,True,200
LA1_1628070500,200,14748,17955,3207,200,False,3,9,6,200,False,True,200
LA1_1623208028,200,15227,14688,539,100,False,5,3,2,100,False,True,200
LA1_1623445604,200,17167,17271,104,200,False,6,9,3,200,False,True,200
LA1_1628059204,200,16686,16234,452,100,False,6,6,0,0,False,True,200
LA1_1623435110,200,17268,16100,1168,100,False,10,6,4,100,False,False,100
LA1_1629520009,100,14557,18635,4078,200,False,0,9,9,200,True,False,200
LA1_1628193378,100,17534,16552,982,100,False,9,6,3,100,True,False,200
LA1_1623184389,100,17510,14860,2650,100,False,7,2,5,100,True,True,100
LA1_1623007794,200,14479,15600,1121,200,False,1,4,3,200,False,True,200
LA1_1623461064,100,13933,16191,2258,200,False,1,4,3,200,True,False,200
LA1_1625540482,100,19459,19343,116,100,False,12,9,3,100,True,True,100
LA1_1623452399,100,20157,15305,4852,100,False,14,3,11,100,True,True,100
LA1_1625547413,100,18494,15451,3043,100,False,10,4,6,100,True,False,200
LA1_1623190434,200,16403,15893,510,100,False,5,3,2,100,False,True,200
LA1_1623424619,200,16480,17380,900,200,False,5,7,2,200,False,False,100
LA1_1627594914,200,15234,18669,3435,200,False,4,12,8,200,False,True,200
LA1_1622922985,200,14427,17885,3458,200,False,2,8,6,200,False,True,200
LA1_1636952202,100,16784,16287,497,100,False,6,5,1,100,True,False,200
LA1_1636087365,200,17596,16083,1513,100,False,9,6,3,100,False,True,200
LA1_1638672804,200,16522,15443,1079,100,False,6,4,2,100,False,True,200
LA1_1636830937,100,17636,18621,985,200,False,9,10,1,200,True,False,200
LA1_1637565178,100,15822,17832,2010,200,False,5,8,3,200,True,False,200
LA1_1638682859,100,16668,18037,1369,200,False,5,11,6,200,True,False,200
LA1_1639252195,100,17728,15682,2046,100,False,8,3,5,100,True,False,200
LA1_1637533305,200,16290,18177,1887,200,False,7,10,3,200,False,True,200
LA1_1639271290,100,16897,15380,1517,100,False,6,2,4,100,True,True,100
LA1_1639258236,200,15292,16328,1036,200,False,4,7,3,200,False,True,200
LA1_1636931416,200,16739,17373,634,200,False,8,10,2,200,False,True,200
LA1_1637310938,200,15647,21279,5632,200,False,5,13,8,200,False,True,200
LA1_1635790943,100,17297,18011,714,200,False,6,8,2,200,True,False,200
LA1_1639247199,100,17051,15145,1906,100,False,6,4,2,100,True,True,100
LA1_1636077884,100,15263,14090,1173,100,False,3,1,2,100,True,True,100
LA1_1637302900,100,20459,14332,6127,100,False,13,1,12,100,True,True,100
LA1_1637291704,200,15412,18741,3329,200,False,6,10,4,200,False,True,200
LA1_1636927271,100,15987,14944,1043,100,False,6,3,3,100,True,True,100
LA1_1637551080,200,18084,18848,764,200,False,11,8,3,100,False,True,200
LA1_1636935760,100,17708,17161,547,100,False,6,7,1,200,True,True,100
LA1_1632786613,200,17358,16612,746,100,False,5,5,0,0,False,False,100
LA1_1632959248,100,18197,16068,2129,100,False,8,5,3,100,True,True,100
LA1_1633211658,200,15883,16733,850,200,False,4,7,3,200,False,True,200
LA1_1630481832,100,15422,17331,1909,200,False,3,5,2,200,True,False,200
LA1_1633294619,200,16363,17057,694,200,False,4,6,2,200,False,True,200
LA1_1632825964,200,16030,18206,2176,200,False,6,8,2,200,False,True,200
LA1_1633194713,200,17221,18605,1384,200,False,7,10,3,200,False,False,100
LA1_1599042037,100,15654,16929,1275,200,False,1,4,3,200,True,False,200
LA1_1596785342,100,17224,17589,365,200,False,4,9,5,200,True,False,200
LA1_1597025685,100,15943,16462,519,200,False,2,3,1,200,True,True,100
LA1_1596747658,200,14721,18984,4263,200,False,2,9,7,200,False,True,200
LA1_1596330908,100,19007,17247,1760,100,False,8,5,3,100,True,True,100
LA1_1596757439,100,19067,16179,2888,100,False,12,4,8,100,True,False,200
LA1_1596602383,200,15411,20029,4618,200,False,4,15,11,200,False,True,200
LA1_1596014648,100,18211,16252,1959,100,False,10,3,7,100,True,True,100
LA1_1596349128,200,16102,19145,3043,200,False,6,14,8,200,False,True,200
LA1_1596062564,100,16270,16888,618,200,False,6,4,2,100,True,True,100
LA1_1596052524,100,14408,16776,2368,200,False,1,4,3,200,True,False,200
LA1_1595872884,200,15852,15279,573,100,False,5,3,2,100,False,False,100
LA1_1596313718,100,15784,15553,231,100,False,3,2,1,100,True,True,100
LA1_1596030547,200,16530,17964,1434,200,False,6,7,1,200,False,True,200
LA1_1596253906,200,15491,14690,801,100,False,3,1,2,100,False,True,200
LA1_1596226962,100,18898,19496,598,200,False,12,11,1,100,True,True,100
LA1_1596241946,100,17136,16011,1125,100,False,9,3,6,100,True,True,100
LA1_1596000160,200,17366,16924,442,100,False,7,7,0,0,False,False,100
LA1_1597098891,200,18151,16917,1234,100,False,7,6,1,100,False,True,200
LA1_1597084073,200,18324,16044,2280,100,False,9,4,5,100,False,True,200
LA1_1637436223,100,17192,17027,165,100,False,7,5,2,100,True,True,100
LA1_1637925636,200,16590,18904,2314,200,False,8,10,2,200,False,True,200
LA1_1637565153,100,15828,16693,865,200,False,2,5,3,200,True,True,100
LA1_1637723208,200,17976,16281,1695,100,False,8,3,5,100,False,True,200
LA1_1637345183,100,18162,17045,1117,100,False,7,7,0,0,False,True,100
LA1_1637552081,100,15964,16603,639,200,False,5,7,2,200,True,False,200
LA1_1637741088,100,17622,18839,1217,200,False,10,11,1,200,True,False,200
LA1_1637803090,100,19286,15664,3622,100,False,10,3,7,100,True,True,100
LA1_1637518264,200,17062,17052,10,100,False,5,6,1,200,False,False,100
LA1_1637467467,200,17552,15684,1868,100,False,6,3,3,100,False,False,100
LA1_1637338347,100,16611,19257,2646,200,False,7,14,7,200,True,False,200
LA1_1637906211,100,18214,15661,2553,100,False,8,3,5,100,True,True,100
LA1_1637450209,100,19376,16187,3189,100,False,12,5,7,100,True,True,100
LA1_1637916138,100,17446,14305,3141,100,False,6,1,5,100,True,True,100
LA1_1637539061,100,16438,15494,944,100,False,5,3,2,100,True,True,100
LA1_1637588098,200,18267,16976,1291,100,False,9,6,3,100,False,True,200
LA1_1637774040,200,16519,17704,1185,200,False,7,6,1,100,False,True,200
LA1_1637490208,200,17082,16286,796,100,False,7,4,3,100,False,False,100
LA1_1640270805,200,15787,17631,1844,200,False,5,9,4,200,False,True,200
LA1_1637199623,100,16624,15531,1093,100,False,5,3,2,100,True,True,100
LA1_1637301229,100,20883,15975,4908,100,False,18,8,10,100,True,True,100
LA1_1636499554,100,15463,15984,521,200,False,3,3,0,0,False,False,200
LA1_1636724104,200,16093,16211,118,200,False,4,5,1,200,False,False,100
LA1_1637273754,200,15743,18183,2440,200,False,3,7,4,200,False,False,100
LA1_1637096705,100,15868,16598,730,200,False,6,4,2,100,True,False,200
LA1_1636045452,100,13793,19616,5823,200,False,2,15,13,200,True,False,200
LA1_1637217251,100,16790,16848,58,200,False,7,5,2,100,True,True,100
LA1_1636924362,100,17298,18097,799,200,False,9,10,1,200,True,False,200
LA1_1637369236,100,18090,17846,244,100,False,7,8,1,200,True,True,100
LA1_1637421854,100,18033,16485,1548,100,False,10,5,5,100,True,True,100
LA1_1637146110,100,17909,17674,235,100,False,9,6,3,100,True,True,100
LA1_1637651131,100,16007,16837,830,200,False,5,7,2,200,True,False,200
LA1_1636223132,100,14720,17462,2742,200,False,3,9,6,200,True,False,200
LA1_1635940166,200,14557,18003,3446,200,False,3,8,5,200,False,True,200
LA1_1637365398,100,18106,15224,2882,100,False,9,4,5,100,True,True,100
LA1_1635988729,100,17058,15298,1760,100,False,6,4,2,100,True,True,100
LA1_1635734118,200,17080,16681,399,100,False,5,6,1,200,False,True,200
LA1_1636459410,100,18093,15588,2505,100,False,9,4,5,100,True,True,100
LA1_1637624999,100,17513,16508,1005,100,False,5,5,0,0,False,True,100
LA1_1636992952,100,17386,15863,1523,100,False,7,4,3,100,True,True,100
LA1_1634763339,100,16438,17857,1419,200,False,7,9,2,200,True,False,200
LA1_1635742711,100,15223,15773,550,200,False,4,3,1,100,True,False,200
LA1_1637230389,200,16731,17186,455,200,False,4,6,2,200,False,True,200
LA1_1637368105,200,14746,16511,1765,200,False,1,3,2,200,False,True,200
LA1_1635537358,200,18588,16012,2576,100,False,10,4,6,100,False,False,100
LA1_1637001701,200,15944,19284,3340,200,False,4,12,8,200,False,True,200
LA1_1637221394,200,17161,17122,39,100,False,7,9,2,200,False,False,100
LA1_1633751035,200,16262,17535,1273,200,False,5,6,1,200,False,True,200
LA1_1634134846,100,16489,15920,569,100,False,5,4,1,100,True,True,100
LA1_1633856773,100,16486,15603,883,100,False,6,4,2,100,True,False,200
LA1_1627361756,100,17343,18225,882,200,False,6,8,2,200,True,False,200
LA1_1634121032,100,16872,15484,1388,100,False,6,3,3,100,True,True,100
LA1_1626579028,100,17889,17799,90,100,False,8,10,2,200,True,True,100
LA1_1634106981,200,18019,16110,1909,100,False,8,5,3,100,False,True,200
LA1_1626375605,100,17146,18215,1069,200,False,6,9,3,200,True,True,100
LA1_1625889610,200,15484,16873,1389,200,False,4,6,2,200,False,False,100
LA1_1627365628,200,22668,17160,5508,100,False,20,8,12,100,False,False,100
LA1_1629238921,100,15023,18273,3250,200,False,3,9,6,200,True,False,200
LA1_1629024386,200,16070,17343,1273,200,False,4,7,3,200,False,False,100
LA1_1633665203,100,20104,15217,4887,100,False,13,3,10,100,True,True,100
LA1_1626592462,200,15995,17830,1835,200,False,4,8,4,200,False,True,200
LA1_1633690063,100,17538,15311,2227,100,False,7,4,3,100,True,True,100
LA1_1633702560,100,16342,18367,2025,200,False,5,9,4,200,True,False,200
LA1_1629057657,200,17202,16842,360,100,False,6,5,1,100,False,False,100
LA1_1633868166,200,19091,17062,2029,100,False,11,5,6,100,False,False,100
LA1_1630491356,200,17069,15134,1935,100,False,6,2,4,100,False,False,100
LA1_1629988833,100,15178,16700,1522,200,False,4,6,2,200,True,False,200
LA1_1628818318,200,18298,14026,4272,100,False,7,1,6,100,False,False,100
LA1_1629028037,100,16442,14966,1476,100,False,5,1,4,100,True,True,100
LA1_1629032128,100,18354,17101,1253,100,False,11,6,5,100,True,True,100
LA1_1628553287,100,16845,15649,1196,100,False,5,5,0,0,False,True,100
LA1_1628533561,200,16688,18770,2082,200,False,7,11,4,200,False,True,200
LA1_1643823549,200,20726,17614,3112,100,False,16,9,7,100,False,False,100
LA1_1643941495,200,19282,15305,3977,100,False,11,5,6,100,False,False,100
LA1_1643741072,200,15234,19071,3837,200,False,3,9,6,200,False,True,200
LA1_1643474781,200,16523,17025,502,200,False,5,8,3,200,False,True,200
LA1_1643437994,100,17262,16351,911,100,False,9,5,4,100,True,True,100
LA1_1643513465,100,14787,17580,2793,200,False,2,7,5,200,True,False,200
LA1_1643521718,100,16436,14498,1938,100,False,6,1,5,100,True,True,100
LA1_1643720912,200,15545,16582,1037,200,False,4,6,2,200,False,False,100
LA1_1643490666,200,16329,18360,2031,200,False,5,7,2,200,False,False,100
LA1_1643817320,200,19656,16830,2826,100,False,12,7,5,100,False,True,200
LA1_1643708522,200,17626,15703,1923,100,False,9,5,4,100,False,False,100
LA1_1643950402,200,16148,16857,709,200,False,4,5,1,200,False,False,100
LA1_1643463934,200,19358,19423,65,200,False,13,13,0,0,False,True,200
LA1_1643425400,200,18596,17194,1402,100,False,9,8,1,100,False,False,100
LA1_1643559016,200,15411,16156,745,200,False,2,7,5,200,False,True,200
LA1_1643830014,200,15993,15231,762,100,False,5,3,2,100,False,False,100
LA1_1643567556,100,18106,16433,1673,100,False,9,7,2,100,True,True,100
LA1_1643835533,200,14728,18085,3357,200,False,3,7,4,200,False,False,100
LA1_1643502895,200,16805,15017,1788,100,False,7,4,3,100,False,False,100
LA1_1643560646,100,16347,16138,209,100,False,5,4,1,100,True,True,100
LA1_1621273622,200,16549,15555,994,100,False,4,3,1,100,False,False,100
LA1_1621238719,100,16256,15462,794,100,False,7,5,2,100,True,True,100
LA1_1627936316,200,14824,17095,2271,200,False,1,6,5,200,False,True,200
LA1_1621245229,100,16499,16472,27,100,False,5,6,1,200,True,True,100
LA1_1627394927,100,17437,15384,2053,100,False,6,3,3,100,True,True,100
LA1_1620012982,200,17656,19958,2302,200,False,9,14,5,200,False,True,200
LA1_1624184476,100,14986,16145,1159,200,False,2,3,1,200,True,False,200
LA1_1627942784,100,15908,15981,73,200,False,4,4,0,0,False,False,200
LA1_1621474663,100,19168,16785,2383,100,False,12,6,6,100,True,True,100
LA1_1621495027,200,15639,20789,5150,200,False,4,17,13,200,False,True,200
LA1_1619996626,100,17554,15191,2363,100,False,7,2,5,100,True,False,200
LA1_1618963618,100,15022,16721,1699,200,False,6,5,1,100,True,False,200
LA1_1621248775,200,17807,18240,433,200,False,9,12,3,200,False,False,100
LA1_1627928580,100,16812,18257,1445,200,False,6,10,4,200,True,False,200
LA1_1621266313,100,17261,16669,592,100,False,8,4,4,100,True,True,100
LA1_1627402135,200,16057,16477,420,200,False,4,6,2,200,False,True,200
LA1_1621483962,200,16721,15830,891,100,False,7,5,2,100,False,True,200
LA1_1621063080,100,19777,15488,4289,100,False,13,6,7,100,True,True,100
LA1_1621257249,200,15036,15744,708,200,False,5,5,0,0,False,False,100
LA1_1639673578,200,16261,17370,1109,200,False,3,6,3,200,False,True,200
LA1_1638996137,100,15303,16289,986,200,False,3,3,0,0,False,False,200
LA1_1637918507,200,16072,17335,1263,200,False,5,6,1,200,False,False,100
LA1_1639637712,100,15884,17169,1285,200,False,6,4,2,100,True,True,100
LA1_1638443242,200,16790,15302,1488,100,False,7,4,3,100,False,False,100
LA1_1637699553,100,16734,16496,238,100,False,6,6,0,0,False,False,200
LA1_1639611903,200,17479,14615,2864,100,False,9,2,7,100,False,False,100
LA1_1640993366,200,17663,19337,1674,200,False,10,14,4,200,False,False,100
LA1_1638042535,200,17451,17355,96,100,False,8,4,4,100,False,False,100
LA1_1635569437,100,16703,20599,3896,200,False,8,13,5,200,True,False,200
LA1_1638223662,200,16104,16200,96,200,False,5,4,1,100,False,False,100
LA1_1635413420,200,17210,17033,177,100,False,7,6,1,100,False,True,200
LA1_1635802310,200,18368,17356,1012,100,False,14,8,6,100,False,False,100
LA1_1636111406,200,15958,17907,1949,200,False,4,8,4,200,False,True,200
LA1_1637767114,200,15367,18118,2751,200,False,4,8,4,200,False,True,200
LA1_1635526089,200,16998,17012,14,200,False,9,10,1,200,False,False,100
LA1_1635510720,100,17407,19169,1762,200,False,6,11,5,200,True,True,100
LA1_1635104866,100,17200,18347,1147,200,False,6,9,3,200,True,False,200
LA1_1635503916,100,15341,16154,813,200,False,4,4,0,0,False,False,200
LA1_1639180434,200,17408,17269,139,100,False,9,3,6,100,False,False,100
LA1_1638210295,100,15755,18263,2508,200,False,4,10,6,200,True,False,200
LA1_1635517550,200,15575,19806,4231,200,False,4,14,10,200,False,True,200
LA1_1638551684,100,20794,16237,4557,100,False,17,6,11,100,True,True,100
LA1_1637779255,200,15501,16464,963,200,False,4,5,1,200,False,False,100
LA1_1635810674,200,16789,20140,3351,200,False,5,13,8,200,False,True,200
LA1_1637802718,100,16841,16498,343,100,False,8,6,2,100,True,False,200
LA1_1636991905,100,16110,16446,336,200,False,4,5,1,200,True,True,100
LA1_1638197755,100,16405,17358,953,200,False,6,6,0,0,False,False,200
LA1_1632272845,200,16539,15269,1270,100,False,4,2,2,100,False,True,200
LA1_1632745942,200,16481,15997,484,100,False,4,3,1,100,False,True,200
LA1_1632105917,100,16083,18278,2195,200,False,6,10,4,200,True,False,200
LA1_1632098499,200,15819,15144,675,100,False,3,4,1,200,False,False,100
LA1_1632282697,100,15656,15519,137,100,False,3,2,1,100,True,False,200
LA1_1632714317,200,18128,15607,2521,100,False,9,4,5,100,False,False,100
LA1_1632729106,200,17135,17682,547,200,False,7,8,1,200,False,True,200
LA1_1632510961,200,15520,16735,1215,200,False,3,6,3,200,False,False,100
LA1_1632260629,100,17521,20151,2630,200,False,10,13,3,200,True,False,200
LA1_1632718083,100,16455,16582,127,200,False,4,5,1,200,True,False,200
LA1_1632720036,200,17912,15133,2779,100,False,7,3,4,100,False,False,100
LA1_1632724217,100,21283,16832,4451,100,False,15,6,9,100,True,True,100
LA1_1632777147,200,16503,15680,823,100,False,4,3,1,100,False,False,100
LA1_1632766919,100,16927,17097,170,200,False,8,6,2,100,True,False,200
LA1_1632711082,100,16093,18439,2346,200,False,5,7,2,200,True,True,100
LA1_1632741545,100,17210,15861,1349,100,False,6,4,2,100,True,True,100
LA1_1632736356,100,15858,17340,1482,200,False,6,8,2,200,True,False,200
LA1_1632267319,100,16233,15689,544,100,False,2,3,1,200,True,False,200
LA1_1632734306,100,21177,16863,4314,100,False,16,7,9,100,True,True,100
LA1_1632256497,200,15409,16633,1224,200,False,3,4,1,200,False,True,200
LA1_1632221865,200,17505,16062,1443,100,False,7,3,4,100,False,False,100
LA1_1632422449,100,16803,16909,106,200,False,7,5,2,100,True,True,100
LA1_1632217134,100,17021,16078,943,100,False,8,3,5,100,True,False,200
LA1_1632202095,200,17320,16733,587,100,False,6,7,1,200,False,True,200
LA1_1628846865,100,18353,17751,602,100,False,11,6,5,100,True,True,100
LA1_1631793058,100,17448,19021,1573,200,False,6,11,5,200,True,False,200
LA1_1632210788,100,16039,17815,1776,200,False,5,8,3,200,True,False,200
LA1_1634669077,200,19066,17346,1720,100,False,11,9,2,100,False,False,100
LA1_1640694917,200,17016,17640,624,200,False,6,9,3,200,False,True,200
LA1_1640503148,200,15057,15587,530,200,False,2,5,3,200,False,False,100
LA1_1640743701,100,17057,15388,1669,100,False,8,4,4,100,True,True,100
LA1_1638773379,200,16786,15882,904,100,False,7,7,0,0,False,False,100
LA1_1640186788,100,17456,15420,2036,100,False,8,4,4,100,True,True,100
LA1_1640715380,100,15382,14946,436,100,False,1,2,1,200,True,False,200
LA1_1640176828,200,17689,15540,2149,100,False,10,3,7,100,False,True,200
LA1_1640215076,100,17062,17154,92,200,False,6,6,0,0,False,True,100
LA1_1640705778,100,16916,18510,1594,200,False,7,10,3,200,True,True,100
LA1_1640673916,200,17843,21081,3238,200,False,11,18,7,200,False,True,200
LA1_1640734584,100,18222,15023,3199,100,False,9,3,6,100,True,True,100
LA1_1638765768,200,14931,17463,2532,200,False,2,7,5,200,False,True,200
LA1_1640682227,200,16752,15958,794,100,False,4,5,1,200,False,False,100
LA1_1640668311,200,14278,16492,2214,200,False,2,5,3,200,False,True,200
LA1_1640725385,200,18107,15738,2369,100,False,8,4,4,100,False,True,200
LA1_1640201116,100,16590,17912,1322,200,False,7,8,1,200,True,False,200
LA1_1638782754,100,15810,20422,4612,200,False,5,13,8,200,True,False,200
LA1_1640687817,100,16274,17136,862,200,False,3,4,1,200,True,False,200
LA1_1640490289,100,15536,17515,1979,200,False,5,8,3,200,True,False,200
LA1_1638791694,200,14689,15347,658,200,False,3,4,1,200,False,True,200
LA1_1625523856,200,15599,16434,835,200,False,3,6,3,200,False,False,100
LA1_1625518574,200,17304,16254,1050,100,False,7,5,2,100,False,False,100
LA1_1626606398,100,17459,15843,1616,100,False,8,4,4,100,True,True,100
LA1_1627263388,100,15015,17430,2415,200,False,4,7,3,200,True,False,200
LA1_1626872499,200,16051,18228,2177,200,False,3,9,6,200,False,False,100
LA1_1626582414,200,19045,14883,4162,100,False,11,2,9,100,False,False,100
LA1_1627129481,100,18033,17737,296,100,False,12,10,2,100,True,False,200
LA1_1625625353,100,16583,17908,1325,200,False,6,7,1,200,True,False,200
LA1_1625264888,200,17592,18132,540,200,False,9,12,3,200,False,False,100
LA1_1626633754,100,15851,14614,1237,100,False,1,0,1,100,True,True,100
LA1_1626590941,200,16113,15717,396,100,False,6,3,3,100,False,True,200
LA1_1627221083,200,16227,17691,1464,200,False,4,7,3,200,False,True,200
LA1_1625641662,100,18098,17657,441,100,False,12,8,4,100,True,False,200
LA1_1627125903,200,16471,15721,750,100,False,5,4,1,100,False,True,200
LA1_1636764110,100,18139,14302,3837,100,False,7,2,5,100,True,True,100
LA1_1635714762,200,19407,16596,2811,100,False,11,7,4,100,False,False,100
LA1_1636789338,200,16958,14919,2039,100,False,7,3,4,100,False,False,100
LA1_1635719605,200,17495,16168,1327,100,False,7,5,2,100,False,True,200
LA1_1635711805,100,16243,14711,1532,100,False,7,3,4,100,True,True,100
LA1_1635720830,100,17378,16141,1237,100,False,9,7,2,100,True,True,100
LA1_1636122585,200,15942,16706,764,200,False,6,6,0,0,False,True,200
LA1_1636823593,100,15773,18841,3068,200,False,5,10,5,200,True,False,200
LA1_1636770297,100,17478,18230,752,200,False,8,10,2,200,True,True,100
LA1_1636111605,100,16457,16166,291,100,False,5,4,1,100,True,False,200
LA1_1635717702,200,15289,16788,1499,200,False,4,7,3,200,False,True,200
LA1_1636847727,200,16451,16907,456,200,False,6,6,0,0,False,True,200
LA1_1636808775,200,17473,16600,873,100,False,8,4,4,100,False,False,100
LA1_1636164777,200,15574,15352,222,100,False,2,3,1,200,False,True,200
LA1_1636780756,100,14840,17318,2478,200,False,3,9,6,200,True,False,200
LA1_1636796880,200,15742,16532,790,200,False,2,6,4,200,False,True,200
LA1_1636836448,100,16234,15357,877,100,False,3,2,1,100,True,True,100
LA1_1636134003,100,15378,19872,4494,200,False,2,15,13,200,True,False,200
LA1_1636097812,100,17400,16490,910,100,False,7,6,1,100,True,False,200
LA1_1635721528,100,18516,17888,628,100,False,12,8,4,100,True,True,100
LA1_1636095231,200,15167,18196,3029,200,False,3,9,6,200,False,False,100
LA1_1635865365,200,17550,18721,1171,200,False,9,12,3,200,False,False,100
LA1_1634371631,200,15693,19625,3932,200,False,4,13,9,200,False,True,200
LA1_1633010473,200,13596,18798,5202,200,False,1,9,8,200,False,True,200
LA1_1632307658,100,19299,16850,2449,100,False,10,7,3,100,True,True,100
LA1_1632336550,200,19639,19066,573,100,False,11,15,4,200,False,False,100
LA1_1632994508,200,18549,15825,2724,100,False,10,2,8,100,False,False,100
LA1_1635682648,100,16215,15929,286,100,False,5,3,2,100,True,True,100
LA1_1632321637,100,17404,16314,1090,100,False,5,6,1,200,True,True,100
LA1_1633634871,200,16843,16503,340,100,False,5,7,2,200,False,True,200
LA1_1633625659,100,19556,15657,3899,100,False,11,4,7,100,True,False,200
LA1_1632996958,100,16778,16561,217,100,False,5,4,1,100,True,True,100
LA1_1632315188,100,14619,16534,1915,200,False,1,4,3,200,True,False,200
LA1_1633424585,200,16032,16507,475,200,False,2,4,2,200,False,True,200
LA1_1632330756,100,15823,15283,540,100,False,5,4,1,100,True,False,200
LA1_1634386718,100,16861,18593,1732,200,False,6,9,3,200,True,False,200
LA1_1633641407,100,17890,15953,1937,100,False,10,2,8,100,True,True,100
LA1_1633400660,200,16498,16252,246,100,False,7,5,2,100,False,True,200
LA1_1634378521,200,15844,18471,2627,200,False,4,8,4,200,False,True,200
LA1_1633416453,200,17364,18945,1581,200,False,10,10,0,0,False,True,200
LA1_1641567839,200,16397,16526,129,200,False,5,6,1,200,False,True,200
LA1_1641548861,100,17239,17145,94,100,False,7,6,1,100,True,False,200
LA1_1641514704,100,17411,15078,2333,100,False,8,2,6,100,True,True,100
LA1_1640664282,200,17404,17125,279,100,False,10,9,1,100,False,True,200
LA1_1640925938,200,16722,18042,1320,200,False,6,11,5,200,False,True,200
LA1_1641394123,200,15911,17455,1544,200,False,5,7,2,200,False,True,200
LA1_1641499866,200,17153,17841,688,200,False,5,8,3,200,False,False,100
LA1_1640397367,200,15880,17372,1492,200,False,4,7,3,200,False,False,100
LA1_1641558221,200,17233,17224,9,100,False,10,6,4,100,False,True,200
LA1_1641054193,100,17811,18171,360,200,False,9,8,1,100,True,False,200
LA1_1640428863,100,16858,15491,1367,100,False,6,3,3,100,True,True,100
LA1_1641507766,200,16816,17150,334,200,False,4,6,2,200,False,False,100
LA1_1641071515,100,16323,17207,884,200,False,7,7,0,0,False,True,100
LA1_1640420405,100,19728,15572,4156,100,False,13,3,10,100,True,False,200
LA1_1641375736,100,16781,18314,1533,200,False,7,10,3,200,True,False,200
LA1_1640412147,200,18242,15848,2394,100,False,9,5,4,100,False,False,100
LA1_1622110971,100,18061,16759,1302,100,False,10,5,5,100,True,True,100
LA1_1621782574,100,17408,19143,1735,200,False,5,11,6,200,True,False,200
LA1_1622111656,200,17863,15834,2029,100,False,7,5,2,100,False,False,100
LA1_1621850660,100,17854,17600,254,100,False,7,8,1,200,True,True,100
LA1_1622106809,200,15869,15291,578,100,False,5,4,1,100,False,True,200
LA1_1622110579,200,17479,17185,294,100,False,7,8,1,200,False,False,100
LA1_1622829423,100,16849,15688,1161,100,False,7,4,3,100,True,True,100
LA1_1622120751,200,14824,16267,1443,200,False,2,4,2,200,False,False,100
LA1_1622124791,200,17481,15530,1951,100,False,6,5,1,100,False,False,100
LA1_1622874532,200,15907,17923,2016,200,False,3,7,4,200,False,True,200
LA1_1622496842,200,16934,15212,1722,100,False,4,3,1,100,False,False,100
LA1_1622840864,200,16263,18447,2184,200,False,5,9,4,200,False,True,200
LA1_1622867664,200,15433,16185,752,200,False,6,3,3,100,False,False,100
LA1_1621837694,200,15235,15060,175,100,False,2,2,0,0,False,False,100
LA1_1621824811,200,15849,18201,2352,200,False,5,8,3,200,False,True,200
LA1_1622757889,100,17783,17976,193,200,False,8,10,2,200,True,False,200
LA1_1622112983,100,18533,16072,2461,100,False,10,5,5,100,True,True,100
LA1_1622110275,100,17076,16200,876,100,False,5,4,1,100,True,True,100
LA1_1622116351,200,17140,19207,2067,200,False,10,11,1,200,False,True,200
LA1_1628344237,100,18473,15320,3153,100,False,9,2,7,100,True,True,100
LA1_1628810847,200,21363,16709,4654,100,False,17,7,10,100,False,False,100
LA1_1628832432,200,16620,17566,946,200,False,6,8,2,200,False,True,200
LA1_1628838430,200,18046,15334,2712,100,False,9,3,6,100,False,False,100
LA1_1630733627,100,16959,14800,2159,100,False,5,1,4,100,True,True,100
LA1_1630585292,200,16368,15811,557,100,False,5,4,1,100,False,True,200
LA1_1629555262,200,18350,14573,3777,100,False,11,3,8,100,False,False,100
LA1_1630574489,100,17584,16477,1107,100,False,7,5,2,100,True,True,100
LA1_1628810699,200,17035,16492,543,100,False,6,4,2,100,False,True,200
LA1_1632053665,100,19318,17942,1376,100,False,12,10,2,100,True,True,100
LA1_1628343432,200,16801,16822,21,200,False,6,8,2,200,False,False,100
LA1_1629550319,100,18755,16315,2440,100,False,11,8,3,100,True,True,100
LA1_1630721816,200,15824,18360,2536,200,False,5,11,6,200,False,True,200
LA1_1629541522,200,16162,15441,721,100,False,6,4,2,100,False,True,200
LA1_1630567186,200,14345,19309,4964,200,False,3,10,7,200,False,True,200
LA1_1628341603,200,17115,17886,771,200,False,7,7,0,0,False,True,200
LA1_1631701597,200,16467,17539,1072,200,False,4,8,4,200,False,False,100
LA1_1628847005,200,15123,16033,910,200,False,1,4,3,200,False,True,200
LA1_1630727518,200,14864,16903,2039,200,False,2,7,5,200,False,True,200
LA1_1631690852,100,16660,16256,404,100,False,7,6,1,100,True,True,100
LA1_1642332769,100,16326,16670,344,200,False,5,7,2,200,True,True,100
LA1_1641927616,200,18384,16194,2190,100,False,9,4,5,100,False,True,200
LA1_1635740666,100,16719,15783,936,100,False,6,5,1,100,True,True,100
LA1_1639648876,100,15704,18297,2593,200,False,4,9,5,200,True,True,100
LA1_1636985345,100,16303,15375,928,100,False,4,2,2,100,True,False,200
LA1_1642390420,200,21383,19777,1606,100,False,19,15,4,100,False,True,200
LA1_1640159343,200,15961,17949,1988,200,False,6,7,1,200,False,True,200
